GISJOIN,YEAR,STATE,STATEA,COUNTY,COUNTYA,AREANAME,AGV001,AGV002,AGX001,AGZ001,AGZ002,AGZ003,AGZ004,AG2001,AG2002,AGQ001,AGU001
"G0100010","1860","Alabama","010","Autauga","0010","Autauga",2901285,125234,778906,16598,8620,47784,190636,1253618,238420,1492038,9607
"G0100030","1860","Alabama","010","Baldwin","0030","Baldwin",468090,20495,294470,3929,11330,1537,41326,208328,42863,251191,3714
"G0100050","1860","Alabama","010","Barbour","0050","Barbour",4960812,181321,1225193,6055,1915,18415,300878,2795392,319293,3114685,16150
"G0100070","1860","Alabama","010","Bibb","0070","Bibb",1442455,112325,608458,8933,12,35618,164367,712851,199985,912836,3842
"G0100090","1860","Alabama","010","Blount","0090","Blount",832500,54835,305025,3835,100,30280,79759,275823,110039,385862,666
"G0100130","1860","Alabama","010","Butler","0130","Butler",2950744,101432,746735,875,0,21214,172943,962479,194157,1156636,6818
"G0100150","1860","Alabama","010","Calhoun","0150","Calhoun",2709394,150088,812766,130,11,59202,220382,1056751,279584,1336335,4342
"G0100170","1860","Alabama","010","Chambers","0170","Chambers",3035933,216501,1132376,16805,0,9204,308711,1797647,317915,2115562,11849
"G0100190","1860","Alabama","010","Cherokee","0190","Cherokee",2979265,166508,739631,1031,58,65596,188137,968053,253733,1221786,3002
"G0100230","1860","Alabama","010","Choctaw","0230","Choctaw",2746506,112246,678377,5658,0,10619,127921,1128894,138540,1267434,7094
"G0100250","1860","Alabama","010","Clarke","0250","Clarke",3255548,143281,808820,70,10,26362,145588,1135015,171950,1306965,7436
"G0100310","1860","Alabama","010","Coffee","0310","Coffee",1004062,41228,392032,0,0,26236,104482,442577,130718,573295,1417
"G0100350","1860","Alabama","010","Conecuh","0350","Conecuh",1045700,73492,458986,3979,50,59085,107213,532063,166298,698361,4882
"G0100370","1860","Alabama","010","Coosa","0370","Coosa",1672376,146061,909070,19574,950,62884,248214,1133849,311098,1444947,5212
"G0100390","1860","Alabama","010","Covington","0390","Covington",538155,39266,324362,97,150,35458,96922,219683,132380,352063,821
"G0100450","1860","Alabama","010","Dale","0450","Dale",1431122,83868,550691,6337,0,70824,169395,620000,240219,860219,1809
"G0100470","1860","Alabama","010","Dallas","0470","Dallas",9311714,245541,1716129,1253,2520,8372,332596,3867186,340968,4208154,25760
"G0100490","1860","Alabama","010","DeKalb","0490","Dekalb",1100609,74053,496116,588,0,85433,126659,402399,212092,614491,848
"G0100570","1860","Alabama","010","Fayette","0570","Fayette",739641,96246,501713,3503,165,93100,130276,542460,223376,765836,1703
"G0100590","1860","Alabama","010","Franklin","0590","Franklin",4096733,140228,838487,649,550,76502,259303,1198311,335805,1534116,8495
"G0100630","1860","Alabama","010","Greene","0630","Greene",9176802,259471,1746454,4925,100,12894,324828,3603507,337722,3941229,23598
"G0100670","1860","Alabama","010","Henry","0670","Henry",2154860,99118,621480,100,0,24892,217648,953163,242540,1195703,4433
"G0100710","1860","Alabama","010","Jackson","0710","Jackson",3121085,98255,837307,393,0,85995,220584,711066,306579,1017645,3405
"G0100730","1860","Alabama","010","Jefferson","0730","Jefferson",1219865,95261,552095,2915,0,51155,130861,629572,182016,811588,2649
"G0100770","1860","Alabama","010","Lauderdale","0770","Lauderdale",4554063,154512,845171,3944,16725,22833,164482,973653,187315,1160968,6737
"G0100790","1860","Alabama","010","Lawrence","0790","Lawrence",2996285,91730,768543,200,100,18263,160823,1135398,179086,1314484,6788
"G0100830","1860","Alabama","010","Limestone","0830","Limestone",3592495,114529,718902,500,400,16551,173593,1090197,190144,1280341,8085
"G0100850","1860","Alabama","010","Lowndes","0850","Lowndes",9040470,405489,1661362,24,0,6709,319844,3369057,326553,3695610,19340
"G0100870","1860","Alabama","010","Macon","0870","Macon",5825099,152394,1291568,140,392,11333,269665,2689006,280998,2970004,18176
"G0100890","1860","Alabama","010","Madison","0890","Madison",6078806,184277,1107685,2102,1898,65305,222761,1728366,288066,2016432,14573
"G0100910","1860","Alabama","010","Marengo","0910","Marengo",10291862,301473,1699142,2427,0,42251,368051,3811380,410302,4221682,24409
"G0100930","1860","Alabama","010","Marion","0930","Marion",729765,85834,493607,1190,0,45862,133406,480232,179268,659500,1283
"G0100950","1860","Alabama","010","Marshall","0950","Marshall",1372766,71393,518027,707,30,44279,125124,525920,169403,695323,1821
"G0100970","1860","Alabama","010","Mobile","0970","Mobile",1186763,40758,389430,11755,89255,0,285743,183746,285743,469489,11376
"G0100990","1860","Alabama","010","Monroe","0990","Monroe",2672000,144549,673257,60,0,28483,148380,1190988,176863,1367851,8705
"G0101010","1860","Alabama","010","Montgomery","1010","Montgomery",9883964,326229,1748273,3999,16464,9997,336915,3658338,346912,4005250,23710
"G0101030","1860","Alabama","010","Morgan","1030","Morgan",1441974,77076,546110,2312,2152,25923,131271,591968,157194,749162,3706
"G0101050","1860","Alabama","010","Perry","1050","Perry",7275412,276479,1305872,576,0,6845,291614,2777351,298459,3075810,18206
"G0101070","1860","Alabama","010","Pickens","1070","Pickens",4016618,263403,1229332,100,0,18391,315826,2024158,334217,2358375,12191
"G0101090","1860","Alabama","010","Pike","1090","Pike",3744687,165763,1133938,11423,35,71320,303472,1772307,374792,2147099,8785
"G0101110","1860","Alabama","010","Randolph","1110","Randolph",1950170,105930,679785,10258,2457,86339,199149,756658,285488,1042146,1904
"G0101130","1860","Alabama","010","Russell","1130","Russell",4959649,208958,964095,6600,4880,4754,237360,2502090,242114,2744204,15638
"G0101150","1860","Alabama","010","St Clair","1150","St Clair",1370662,75371,306026,4219,0,37912,130327,463834,168239,632073,1768
"G0101170","1860","Alabama","010","Shelby","1170","Shelby",1401230,82123,442289,9787,330,36293,137582,615387,173875,789262,3622
"G0101190","1860","Alabama","010","Sumter","1190","Sumter",5303979,248997,1181240,725,150,13265,265522,2341810,278787,2620597,18091
"G0101210","1860","Alabama","010","Talladega","1210","Talladega",3111205,184704,929590,0,0,23327,243906,1419470,267233,1686703,8865
"G0101230","1860","Alabama","010","Tallapoosa","1230","Tallapoosa",3256377,198236,983087,169,0,51621,226291,1334963,277912,1612875,6672
"G0101250","1860","Alabama","010","Tuscaloosa","1250","Tuscaloosa",5925157,260551,1716130,26344,480,37706,256599,1899013,294305,2193318,10145
"G0101270","1860","Alabama","010","Walker","1270","Walker",613820,57797,292831,374,0,32983,74122,301664,107105,408769,519
"G0101290","1860","Alabama","010","Washington","1290","Washington",791710,23920,295576,0,0,0,39579,250339,39579,289918,2494
"G0101310","1860","Alabama","010","Wilcox","1310","Wilcox",7311117,233165,1303368,12577,75,25344,232417,2976153,257761,3233914,17797
"G0101330","1860","Alabama","010","Winston","1330","Winston",231261,21184,111796,2568,698,14970,33678,84865,48648,133513,122
"G0500010","1860","Arkansas","050","Arkansas","0010","Arkansas",5498395,175999,632069,595,120,283,64863,1197764,65146,1262910,4921
"G0500030","1860","Arkansas","050","Ashley","0030","Ashley",2532356,126402,446241,4750,4975,12188,77009,655499,89197,744696,3761
"G0500070","1860","Arkansas","050","Benton","0070","Benton",1411920,70544,494380,440,5,18761,69297,331217,88058,419275,384
"G0500110","1860","Arkansas","050","Bradley","0110","Bradley",2084198,109668,395306,620,0,64369,90482,621060,154851,775911,2690
"G0500130","1860","Arkansas","050","Calhoun","0130","Calhoun",499136,30647,163542,1237,0,5584,36418,260747,42002,302749,981
"G0500150","1860","Arkansas","050","Carroll","0150","Carroll",836970,62775,606162,170,0,51119,80223,379019,131342,510361,330
"G0500170","1860","Arkansas","050","Chicot","0170","Chicot",4399554,234555,572910,0,35,0,28370,2150568,28370,2178938,7512
"G0500190","1860","Arkansas","050","Clark","0190","Clark",1254607,65452,461429,440,90,11408,74961,562711,86369,649080,2214
"G0500270","1860","Arkansas","050","Columbia","0270","Columbia",2041073,156534,615518,2510,2883,9951,117106,1009571,127057,1136628,3599
"G0500290","1860","Arkansas","050","Conway","0290","Conway",923263,33470,336848,0,0,13117,68644,314904,81761,396665,802
"G0500310","1860","Arkansas","050","Craighead","0310","Craighead",268982,16589,108699,8,30,3767,18464,70837,22231,93068,87
"G0500330","1860","Arkansas","050","Crawford","0330","Crawford",615073,50663,297229,455,1843,6541,54587,167380,61128,228508,858
"G0500350","1860","Arkansas","050","Crittenden","0350","Crittenden",2408415,51871,333843,5,4700,70,36221,339007,36291,375298,2347
"G0500390","1860","Arkansas","050","Dallas","0390","Dallas",1530234,75500,348141,20,0,11956,63784,647200,75740,722940,3494
"G0500410","1860","Arkansas","050","Desha","0410","Desha",4098240,128064,403250,960,3100,0,49313,731881,49313,781194,3784
"G0500430","1860","Arkansas","050","Drew","0430","Drew",1062123,67024,447800,1992,54,7122,81960,668091,89082,757173,3497
"G0500470","1860","Arkansas","050","Franklin","0470","Franklin",1030882,42288,402743,575,0,21231,97310,374572,118541,493113,962
"G0500490","1860","Arkansas","050","Fulton","0490","Fulton",466340,25268,201431,120,0,22767,36312,154984,59079,214063,88
"G0500550","1860","Arkansas","050","Greene","0550","Greene",575574,45666,311609,295,0,26257,60732,199507,86989,286496,189
"G0500570","1860","Arkansas","050","Hempstead","0570","Hempstead",3029418,156522,775743,23,27,67848,166914,1148840,234762,1383602,5398
"G0500590","1860","Arkansas","050","Hot Spring","0590","Hot Spring",797525,64013,313248,0,0,64569,88446,272502,153015,425517,613
"G0500630","1860","Arkansas","050","Independence","0630","Independence",1695951,107267,620398,2425,185,51110,143282,512168,194392,706560,1337
"G0500650","1860","Arkansas","050","Izard","0650","Izard",750076,32496,339969,0,3,32163,71393,258225,103556,361781,382
"G0500670","1860","Arkansas","050","Jackson","0670","Jackson",2063231,93719,475297,5,598,326,13732,663028,14058,677086,2535
"G0500690","1860","Arkansas","050","Jefferson","0690","Jefferson",6952596,276942,658332,4527,830,2043,89775,1663304,91818,1755122,7146
"G0500710","1860","Arkansas","050","Johnson","0710","Johnson",947405,155482,444800,0,32,32334,89134,326970,121468,448438,973
"G0500730","1860","Arkansas","050","Lafayette","0730","Lafayette",2356283,70945,461447,0,0,3242,65299,1017211,68541,1085752,4311
"G0500750","1860","Arkansas","050","Lawrence","0750","Lawrence",1089470,72614,574328,290,0,37827,98623,332654,136450,469104,494
"G0500870","1860","Arkansas","050","Madison","0870","Madison",757783,59917,408271,31,154,38644,87920,300677,126564,427241,296
"G0500890","1860","Arkansas","050","Marion","0890","Marion",462956,33379,291258,50,41,23284,53923,1220415,77207,1297622,261
"G0500930","1860","Arkansas","050","Mississippi","0930","Mississippi",1741201,22829,265395,0,0,2386,39060,212487,41446,253933,1461
"G0500950","1860","Arkansas","050","Monroe","0950","Monroe",1458212,54438,302406,121,30,959,58143,455628,59102,514730,2226
"G0500970","1860","Arkansas","050","Montgomery","0970","Montgomery",294250,30635,202406,250,0,27251,49609,125854,76860,202714,92
"G0501010","1860","Arkansas","050","Newton","1010","Newton",190491,17202,171739,0,0,14843,27944,116957,42787,159744,24
"G0501030","1860","Arkansas","050","Ouachita","1030","Ouachita",1988237,102852,453696,1905,0,3597,45290,725940,48887,774827,4478
"G0501050","1860","Arkansas","050","Perry","1050","Perry",422441,24518,145484,0,0,3952,23850,121182,27802,148984,303
"G0501070","1860","Arkansas","050","Phillips","1070","Phillips",8037268,169685,780682,5012,1280,65,105091,1640143,105156,1745299,8941
"G0501090","1860","Arkansas","050","Pike","1090","Pike",439436,35032,193480,30,0,15931,45488,131522,61419,192941,227
"G0501110","1860","Arkansas","050","Poinsett","1110","Poinsett",912217,40279,212315,0,0,4750,21415,200195,26165,226360,1086
"G0501130","1860","Arkansas","050","Polk","1130","Polk",297360,28554,189152,0,0,18357,35265,104512,53622,158134,172
"G0501150","1860","Arkansas","050","Pope","1150","Pope",1032383,67086,433068,80,0,77427,75636,417548,153063,570611,978
"G0501170","1860","Arkansas","050","Prairie","1170","Prairie",2051830,53992,334467,4100,200,4362,86602,498463,90964,589427,2839
"G0501190","1860","Arkansas","050","Pulaski","1190","Pulaski",3361692,105600,432798,1460,9330,4025,83341,770337,87366,857703,3505
"G0501210","1860","Arkansas","050","Randolph","1210","Randolph",711021,24187,390623,5,0,7980,48964,198775,56944,255719,359
"G0501230","1860","Arkansas","050","St Francis","1230","St Francis",2498918,82091,570183,434,0,8335,117563,669679,125898,795577,2621
"G0501250","1860","Arkansas","050","Saline","1250","Saline",690206,54153,315245,25,0,13237,70523,315426,83760,399186,749
"G0501270","1860","Arkansas","050","Scott","1270","Scott",520782,41763,283432,20,0,14266,50811,162994,65077,228071,215
"G0501290","1860","Arkansas","050","Searcy","1290","Searcy",318198,26610,239008,35,0,22692,54009,176438,76701,253139,93
"G0501310","1860","Arkansas","050","Sebastian","1310","Sebastian",956068,49509,339008,1000,0,8947,62427,172529,71374,243903,680
"G0501330","1860","Arkansas","050","Sevier","1330","Sevier",2284692,107022,548433,175,40,19795,133766,794480,153561,948041,3366
"G0501390","1860","Arkansas","050","Union","1390","Union",2089904,136719,608265,17730,110,19204,146920,1168521,166124,1334645,6331
"G0501410","1860","Arkansas","050","Van Buren","1410","Van Buren",506147,34006,274913,0,0,19204,61475,164814,80679,245493,200
"G0501430","1860","Arkansas","050","Washington","1430","Washington",2010927,123783,747078,450,7025,36314,129095,539510,165409,704919,1493
"G0501450","1860","Arkansas","050","White","1450","White",1193912,30814,345628,565,0,9112,63501,412711,72613,485324,1432
"G0501490","1860","Arkansas","050","Yell","1490","Yell",1201951,19692,375832,85,125,22368,68705,362091,91073,453164,998
"G0600010","1860","California","060","Alameda","0010","Alameda",4247430,173254,1645399,28530,129720,0,149268,1687997,149268,1837265,
"G0600050","1860","California","060","Amador","0050","Amador",989045,51907,788351,20910,26840,0,176661,192465,176661,369126,
"G0600070","1860","California","060","Butte","0070","Butte",1157980,53775,1007130,13277,4925,0,71575,306293,71575,377868,
"G0600090","1860","California","060","Calaveras","0090","Calaveras",491065,35197,541604,26567,28972,0,213030,145423,213030,358453,
"G0600110","1860","California","060","Colusa","0110","Colusa",878240,36480,1349795,200,600,0,44695,239021,44695,283716,
"G0600130","1860","California","060","Contra Costa","0130","Contra Costa",1888659,114529,1291528,9835,11394,80080,84989,711692,165069,876761,
"G0600150","1860","California","060","Del Norte","0150","Del Norte",250500,26970,149180,0,9175,0,32665,63742,32665,96407,
"G0600170","1860","California","060","El Dorado","0170","El Dorado",943120,1055,731104,84815,48466,0,354054,204732,354054,558786,
"G0600190","1860","California","060","Fresno","0190","Fresno",118140,5940,293450,150,1100,0,1650,28635,1650,30285,
"G0600230","1860","California","060","Humboldt","0230","Humboldt",324976,19760,149939,410,3350,0,18551,80811,18551,99362,
"G0600315","1860","California","060","Klamath","0315","Klamath",104800,4150,117505,300,1000,0,21093,27863,21093,48956,
"G0600370","1860","California","060","Los Angeles","0370","Los Angeles",1621375,44865,1451089,57290,8920,80040,13800,311838,93840,405678,
"G0600410","1860","California","060","Marin","0410","Marin",758339,34876,754748,300,0,0,40177,275325,40177,315502,
"G0600430","1860","California","060","Mariposa","0430","Mariposa",176060,17370,269345,150,3425,0,72000,41467,72000,113467,
"G0600450","1860","California","060","Mendocino","0450","Mendocino",523195,39622,1193882,0,100,0,32242,107115,32242,139357,
"G0600470","1860","California","060","Merced","0470","Merced",326830,25620,642111,3800,4915,0,16795,110699,16795,127494,
"G0600530","1860","California","060","Monterey","0530","Monterey",1153970,41115,1073309,4415,4080,0,59718,447241,59718,506959,
"G0600550","1860","California","060","Napa","0550","Napa",2650095,118740,957025,30215,450,48794,67302,789277,116096,905373,
"G0600570","1860","California","060","Nevada","0570","Nevada",304250,19691,289880,5770,32500,0,110300,69547,110300,179847,
"G0600610","1860","California","060","Placer","0610","Placer",565165,30976,513157,21925,39186,16059,67665,225443,83724,309167,
"G0600630","1860","California","060","Plumas","0630","Plumas",481000,29180,467400,0,51275,0,74550,215706,74550,290256,
"G0600670","1860","California","060","Sacramento","0670","Sacramento",3470000,161182,1612226,70360,139214,0,37102,1337914,37102,1375016,
"G0600710","1860","California","060","San Bernardino","0710","San Bernardino",280137,17981,141661,2450,300,0,16392,38294,16392,54686,
"G0600730","1860","California","060","San Diego","0730","San Diego",269800,24450,412300,400,800,0,23315,35680,23315,58995,
"G0600750","1860","California","060","San Francisco","0750","San Francisco",519900,8000,142205,0,72800,0,0,138590,0,138590,
"G0600770","1860","California","060","San Joaquin","0770","San Joaquin",2327097,194859,1445212,10450,11490,0,8885,891481,8885,900366,
"G0600790","1860","California","060","San Luis Obispo","0790","San Luis Obispo",582700,12271,1120810,1100,3500,0,6000,138957,6000,144957,
"G0600810","1860","California","060","San Mateo","0810","San Mateo",1907697,78057,701051,1545,28476,0,74907,411965,74907,486872,
"G0600830","1860","California","060","Santa Barbara","0830","Santa Barbara",957660,10650,1422435,11700,150,0,35500,63267,35500,98767,
"G0600850","1860","California","060","Santa Clara","0850","Santa Clara",2962410,167330,1325635,30095,46550,0,64645,872428,64645,937073,
"G0600870","1860","California","060","Santa Cruz","0870","Santa Cruz",887223,51498,308907,5480,0,0,10360,340964,10360,351324,
"G0600890","1860","California","060","Shasta","0890","Shasta",396455,29985,333210,16250,18310,0,82035,136209,82035,218244,
"G0600910","1860","California","060","Sierra","0910","Sierra",94800,610,21585,3700,48930,14590,166936,58607,181526,240133,
"G0600930","1860","California","060","Siskiyou","0930","Siskiyou",875730,68862,1110317,100,82040,1735,172022,294197,173757,467954,
"G0600950","1860","California","060","Solano","0950","Solano",2529460,106000,1591898,26785,44520,4170,168085,796813,172255,969068,
"G0600970","1860","California","060","Sonoma","0970","Sonoma",2989110,138857,1591648,29131,8187,1024,129009,824120,130033,954153,
"G0600990","1860","California","060","Stanislaus","0990","Stanislaus",456460,35051,728581,600,4525,0,38254,114644,38254,152898,
"G0601010","1860","California","060","Sutter","1010","Sutter",1256510,103366,1217577,4000,7350,0,86564,340470,86564,427034,
"G0601030","1860","California","060","Tehama","1030","Tehama",946343,96053,752470,13670,8800,250,30427,401115,30677,431792,
"G0601050","1860","California","060","Trinity","1050","Trinity",218760,12005,170427,650,66775,0,119971,99393,119971,219364,
"G0601070","1860","California","060","Tulare","1070","Tulare",372835,32763,1212381,1300,5105,8711,75995,86058,84706,170764,
"G0601090","1860","California","060","Tuolumne","1090","Tuolumne",475260,28565,325465,54980,49260,0,139460,175969,139460,315429,
"G0601130","1860","California","060","Yolo","1130","Yolo",2209273,165949,1379750,18141,24060,200,92267,1075699,92467,1168166,
"G0601150","1860","California","060","Yuba","1150","Yuba",1786950,89090,840335,142490,80320,0,148912,668641,148912,817553,
"G0900010","1860","Connecticut","090","Fairfield","0010","Fairfield",15944882,310222,1735071,77972,107539,2754,521811,2030780,524565,2555345,
"G0900030","1860","Connecticut","090","Hartford","0030","Hartford",19863632,553633,1961211,120013,144768,9361,606643,2624632,616004,3240636,
"G0900050","1860","Connecticut","090","Litchfield","0050","Litchfield",14414234,365183,2225611,65333,4907,4700,430559,2527579,435259,2962838,
"G0900070","1860","Connecticut","090","Middlesex","0070","Middlesex",5730601,139714,809209,44643,4174,8660,197721,962073,206381,1168454,
"G0900090","1860","Connecticut","090","New Haven","0090","New Haven",13973306,347517,1656898,83057,39810,8104,540089,1809942,548193,2358135,
"G0900110","1860","Connecticut","090","New London","0110","New London",9464882,250818,1242262,45727,25004,2889,379067,1398054,381956,1780010,
"G0900130","1860","Connecticut","090","Tolland","0130","Tolland",3826376,153377,606473,19783,4766,7647,187543,675317,195190,870507,
"G0900150","1860","Connecticut","090","Windham","0150","Windham",7612095,219017,1074344,52320,6057,4839,318559,1394852,323398,1718250,
"G1000010","1860","Delaware","100","Kent","0010","Kent",8778258,223222,911936,35694,2066,3021,173470,1757126,176491,1933617,203
"G1000030","1860","Delaware","100","New Castle","0030","New Castle",16633176,433003,1423443,65342,35379,59,190096,2659115,190155,2849270,254
"G1000050","1860","Delaware","100","Sussex","0050","Sussex",6014923,161658,809327,13189,352,14511,209509,1429868,224020,1653888,1341
"G1100010","1860","District Of Columbia","110","District Of Columbia","0010","District Of Columbia",2989267,54408,109640,9980,139408,440,55440,263374,55880,319254,3185
"G1200010","1860","Florida","120","Alachua","0010","Alachua",1403602,87924,330938,1812,60,5182,43177,312047,48359,360406,4457
"G1200090","1860","Florida","120","Brevard","0090","Brevard",23340,440,15780,0,0,0,1900,4840,1900,6740,21
"G1200130","1860","Florida","120","Calhoun","0130","Calhoun",218540,17650,69110,0,0,0,15870,72912,15870,88782,524
"G1200190","1860","Florida","120","Clay","0190","Clay",126880,9222,85049,0,500,20,14965,80988,14985,95973,519
"G1200230","1860","Florida","120","Columbia","0230","Columbia",612492,35901,220243,4405,5797,2362,46920,174833,49282,224115,2063
"G1200250","1860","Florida","120","Dade","0250","Dade",,,,,,,,,,,2
"G1200310","1860","Florida","120","Duval","0310","Duval",220317,11490,47669,165,2370,1,14084,45873,14085,59958,1987
"G1200330","1860","Florida","120","Escambia","0330","Escambia",28875,936,40790,1200,100,0,1660,9579,1660,11239,1961
"G1200370","1860","Florida","120","Franklin","0370","Franklin",5000,650,50,0,1900,0,0,2458,0,2458,520
"G1200390","1860","Florida","120","Gadsden","0390","Gadsden",1417050,155450,362765,0,0,5,121875,495182,121880,617062,5409
"G1200470","1860","Florida","120","Hamilton","0470","Hamilton",441993,17068,177176,0,0,2698,54978,182939,57676,240615,1397
"G1200530","1860","Florida","120","Hernando","0530","Hernando",,,,,,,,,,,200
"G1200570","1860","Florida","120","Hillsborough","0570","Hillsborough",178670,11031,255519,0,0,50,37939,63085,37989,101074,564
"G1200590","1860","Florida","120","Holmes","0590","Holmes",62753,5856,58250,690,0,5390,14148,36057,19538,55595,112
"G1200630","1860","Florida","120","Jackson","0630","Jackson",1366189,54780,399002,0,0,2672,100196,598254,102868,701122,4903
"G1200650","1860","Florida","120","Jefferson","0650","Jefferson",1646074,88293,398893,30,50,3858,99909,761269,103767,865036,6374
"G1200670","1860","Florida","120","Lafayette","0670","Lafayette",179090,6544,46937,20,54,3738,11893,66208,15631,81839,577
"G1200730","1860","Florida","120","Leon","0730","Leon",2482211,94363,503526,225,0,888,132142,1132265,133030,1265295,9089
"G1200750","1860","Florida","120","Levy","0750","Levy",84017,3518,89178,0,607,635,13113,25641,13748,39389,450
"G1200770","1860","Florida","120","Liberty","0770","Liberty",373940,7336,75257,350,0,2111,24969,78395,27080,105475,521
"G1200790","1860","Florida","120","Madison","0790","Madison",1460002,64319,347410,0,0,5132,126041,541819,131173,672992,4249
"G1200810","1860","Florida","120","Manatee","0810","Manatee",97095,6512,194400,0,0,0,5580,34621,5580,40201,253
"G1200830","1860","Florida","120","Marion","0830","Marion",1887115,83790,447268,0,10,500,73107,411323,73607,484930,5314
"G1200870","1860","Florida","120","Monroe","0870","Monroe",11300,95,0,100,3600,0,0,3815,0,3815,451
"G1200890","1860","Florida","120","Nassau","0890","Nassau",145455,5832,138811,25,1100,88,13665,40197,13753,53950,1612
"G1200895","1860","Florida","120","New River","0895","New River",365049,26250,219637,4111,1425,3681,39453,116895,43134,160029,744
"G1200950","1860","Florida","120","Orange","0950","Orange",90555,8681,58295,65,0,372,9081,20453,9453,29906,163
"G1201070","1860","Florida","120","Putnam","1070","Putnam",210800,19139,111850,50,150,90,17960,63652,18050,81702,1047
"G1201090","1860","Florida","120","St Johns","1090","St Johns",69530,5770,67800,500,2010,0,6233,21230,6233,27463,1003
"G1201130","1860","Florida","120","Santa Rosa","1130","Santa Rosa",23285,768,30248,0,0,0,2927,8543,2927,11470,1371
"G1201190","1860","Florida","120","Sumter","1190","Sumter",199873,2302,173914,0,0,0,15332,44665,15332,59997,549
"G1201210","1860","Florida","120","Suwannee","1210","Suwannee",300207,16139,102148,1715,1095,619,26647,91184,27266,118450,835
"G1201230","1860","Florida","120","Taylor","1230","Taylor",75625,4590,58124,0,0,2524,18128,33644,20652,54296,125
"G1201270","1860","Florida","120","Volusia","1270","Volusia",99810,9672,113984,4150,0,60,6550,31430,6610,38040,297
"G1201290","1860","Florida","120","Wakulla","1290","Wakulla",287339,14506,98626,0,0,1370,31897,95205,33267,128472,1167
"G1201310","1860","Florida","120","Walton","1310","Walton",154671,12052,126711,1646,0,12232,30574,70021,42806,112827,441
"G1201330","1860","Florida","120","Washington","1330","Washington",86983,11800,87998,0,0,6981,20991,56699,27972,84671,474
"G1300010","1860","Georgia","130","Appling","0010","Appling",364901,27679,258539,0,0,12490,50973,126691,63463,190154,745
"G1300070","1860","Georgia","130","Baker","0070","Baker",1666965,40439,259195,0,0,324,51210,562118,51534,613652,3492
"G1300090","1860","Georgia","130","Baldwin","0090","Baldwin",1110163,52502,314300,2630,2120,7228,100632,545837,107860,653697,4929
"G1300110","1860","Georgia","130","Banks","0110","Banks",248484,21841,138520,33,16,17493,46124,133603,63617,197220,1086
"G1300190","1860","Georgia","130","Berrien","0190","Berrien",474950,16044,183293,0,0,8285,46092,103062,54377,157439,432
"G1300210","1860","Georgia","130","Bibb","0210","Bibb",1414050,45506,301109,7451,9025,1383,92965,490787,94348,585135,6790
"G1300270","1860","Georgia","130","Brooks","0270","Brooks",1486140,88994,318199,0,0,9868,98756,388511,108624,497135,3282
"G1300290","1860","Georgia","130","Bryan","0290","Bryan",524561,31524,141331,0,0,1450,24164,111286,25614,136900,2379
"G1300310","1860","Georgia","130","Bulloch","0310","Bulloch",908337,43555,344724,2926,0,11854,74593,192919,86447,279366,2162
"G1300330","1860","Georgia","130","Burke","0330","Burke",4034000,93565,766079,240,1850,2479,176174,1545622,178653,1724275,12052
"G1300350","1860","Georgia","130","Butts","0350","Butts",932303,52202,255789,4090,0,9866,84158,403224,94024,497248,3067
"G1300370","1860","Georgia","130","Calhoun","0370","Calhoun",1028452,33962,194867,0,0,3628,57632,388321,61260,449581,2731
"G1300390","1860","Georgia","130","Camden","0390","Camden",901520,61031,94824,30,0,0,11610,318385,11610,329995,4143
"G1300395","1860","Georgia","130","Campbell","0395","Campbell",1255086,54776,288181,2121,40,13771,78863,387358,92634,479992,2004
"G1300450","1860","Georgia","130","Carroll","0450","Carroll",1351973,52450,362755,245,9,12923,93750,434190,106673,540863,1862
"G1300455","1860","Georgia","130","Cass","0455","Cass",2257227,81820,404961,50,10,15025,116656,610333,131681,742014,4282
"G1300470","1860","Georgia","130","Catoosa","0470","Catoosa",822780,23895,120281,0,0,3664,32513,124800,36177,160977,710
"G1300490","1860","Georgia","130","Charlton","0490","Charlton",61955,3844,68254,0,0,646,11728,22414,12374,34788,557
"G1300510","1860","Georgia","130","Chatham","0510","Chatham",3216604,60688,217787,445,79250,4175,16095,822819,20270,843089,14807
"G1300530","1860","Georgia","130","Chattahoochee","0530","Chattahoochee",1027088,35889,226198,1045,0,956,64534,469531,65490,535021,2758
"G1300550","1860","Georgia","130","Chattooga","0550","Chattooga",522273,50083,258735,0,0,11601,76003,312128,87604,399732,2054
"G1300570","1860","Georgia","130","Cherokee","0570","Cherokee",1358284,46279,316222,77,24,21613,98328,343582,119941,463523,1199
"G1300590","1860","Georgia","130","Clarke","0590","Clarke",1049806,44518,259100,207,74,5747,84934,333353,90681,424034,5660
"G1300610","1860","Georgia","130","Clay","0610","Clay",762111,32632,179323,145,75,4728,57869,389652,62597,452249,2253
"G1300630","1860","Georgia","130","Clayton","0630","Clayton",660807,32751,154946,2268,0,10130,39131,202525,49261,251786,1226
"G1300650","1860","Georgia","130","Clinch","0650","Clinch",368176,13963,135751,0,0,6615,41473,69534,48088,117622,449
"G1300670","1860","Georgia","130","Cobb","0670","Cobb",1533869,83757,330464,1059,1142,22351,99346,423730,121697,545427,3819
"G1300690","1860","Georgia","130","Coffee","0690","Coffee",273622,15576,197213,0,0,8484,41931,94383,50415,144798,663
"G1300710","1860","Georgia","130","Colquitt","0710","Colquitt",137187,4660,76001,0,0,3101,19376,43802,22477,66279,110
"G1300730","1860","Georgia","130","Columbia","0730","Columbia",2104579,157512,471753,3415,200,3133,114153,728644,117286,845930,8293
"G1300770","1860","Georgia","130","Coweta","0770","Coweta",2613497,106079,649956,1567,500,13770,161510,1093194,175280,1268474,7248
"G1300790","1860","Georgia","130","Crawford","0790","Crawford",1232668,54185,318006,0,0,6512,80849,639750,87361,727111,4270
"G1300830","1860","Georgia","130","Dade","0830","Dade",415160,15200,111270,0,0,7409,23448,93468,30857,124325,300
"G1300850","1860","Georgia","130","Dawson","0850","Dawson",397507,20151,112355,467,0,13933,34135,106630,48068,154698,326
"G1300870","1860","Georgia","130","Decatur","0870","Decatur",2205996,131318,507581,111,30,8989,112824,682307,121813,804120,5924
"G1300890","1860","Georgia","130","DeKalb","0890","De Kalb",929906,48711,246530,518,55,9869,105721,248330,115590,363920,2000
"G1300930","1860","Georgia","130","Dooly","0930","Dooly",1657347,32899,456520,0,0,10963,123119,712469,134082,846551,4070
"G1300950","1860","Georgia","130","Dougherty","0950","Dougherty",2995923,62672,429446,0,0,25,68940,1161731,68965,1230696,6079
"G1300990","1860","Georgia","130","Early","0990","Early",1544969,154170,466063,0,0,3494,99449,610427,102943,713370,4057
"G1301010","1860","Georgia","130","Echols","1010","Echols",205971,13037,101767,0,0,2436,23699,59112,26135,85247,314
"G1301030","1860","Georgia","130","Effingham","1030","Effingham",696413,28694,194497,163,35,450,50529,129621,50979,180600,2165
"G1301050","1860","Georgia","130","Elbert","1050","Elbert",1901904,76633,330349,651,125,14050,123431,478928,137481,616409,5711
"G1301070","1860","Georgia","130","Emanuel","1070","Emanuel",238396,23150,321833,120,0,11896,69679,178630,81575,260205,1294
"G1301110","1860","Georgia","130","Fannin","1110","Fannin",366968,13828,95585,326,474,3754,27395,87589,31149,118738,143
"G1301130","1860","Georgia","130","Fayette","1130","Fayette",1069610,44683,248871,306,0,654,82843,386421,83497,469918,2019
"G1301150","1860","Georgia","130","Floyd","1150","Floyd",2593322,150403,550472,281,2180,20304,201766,818780,222070,1040850,5913
"G1301170","1860","Georgia","130","Forsyth","1170","Forsyth",766896,19534,211490,325,0,29217,38424,205709,67641,273350,890
"G1301190","1860","Georgia","130","Franklin","1190","Franklin",942449,23226,171418,144,3437,6751,50816,181895,57567,239462,1313
"G1301210","1860","Georgia","130","Fulton","1210","Fulton",723345,25891,179937,130,1700,4608,38511,118231,43119,161350,2955
"G1301230","1860","Georgia","130","Gilmer","1230","Gilmer",520111,22559,159877,2245,1689,23281,53840,159799,77121,236920,167
"G1301250","1860","Georgia","130","Glascock","1250","Glascock",345665,15244,91366,0,0,3971,40571,131520,44542,176062,758
"G1301270","1860","Georgia","130","Glynn","1270","Glynn",614582,46920,79925,0,0,50,10595,186233,10645,196878,2839
"G1301290","1860","Georgia","130","Gordon","1290","Gordon",2004875,73089,364210,92,150,17146,114172,450824,131318,582142,2106
"G1301330","1860","Georgia","130","Greene","1330","Greene",1855185,108946,424107,8711,7407,41619,157951,707766,199570,907336,8398
"G1301350","1860","Georgia","130","Gwinnett","1350","Gwinnett",1116021,59876,330203,3102,212,33227,90276,364300,123503,487803,2551
"G1301370","1860","Georgia","130","Habersham","1370","Habersham",725983,33655,174809,2216,9846,34178,55756,152922,89934,242856,787
"G1301390","1860","Georgia","130","Hall","1390","Hall",948172,46195,244189,446,0,39321,83364,257733,122685,380418,1261
"G1301410","1860","Georgia","130","Hancock","1410","Hancock",2179578,79662,489441,1281,0,1648,152084,977861,153732,1131593,8137
"G1301430","1860","Georgia","130","Haralson","1430","Haralson",314653,24638,99652,0,0,16847,33254,97767,50101,147868,229
"G1301450","1860","Georgia","130","Harris","1450","Harris",1946175,75789,590645,0,0,2805,169828,1058094,172633,1230727,7736
"G1301470","1860","Georgia","130","Hart","1470","Hart",738093,49131,171331,7,0,34175,58414,192003,92589,284592,1528
"G1301490","1860","Georgia","130","Heard","1490","Heard",1143428,24288,283215,434,1645,11150,97767,486593,108917,595510,2811
"G1301510","1860","Georgia","130","Henry","1510","Henry",1634542,70189,427893,4582,0,24477,121888,732773,146365,879138,4515
"G1301530","1860","Georgia","130","Houston","1530","Houston",3524197,91404,700095,0,0,1310,186959,1804223,188269,1992492,10755
"G1301550","1860","Georgia","130","Irwin","1550","Irwin",142475,9615,119882,395,0,6897,27410,65284,34307,99591,246
"G1301570","1860","Georgia","130","Jackson","1570","Jackson",1256652,60657,283897,1057,47,14670,91487,289384,106157,395541,3329
"G1301590","1860","Georgia","130","Jasper","1590","Jasper",1513478,65243,423084,4854,1239,20364,131581,704928,151945,856873,6954
"G1301630","1860","Georgia","130","Jefferson","1630","Jefferson",1845175,82653,459654,31,0,2297,146021,742562,148318,890880,6045
"G1301670","1860","Georgia","130","Johnson","1670","Johnson",515880,18057,141779,0,0,11934,42603,158454,54537,212991,849
"G1301690","1860","Georgia","130","Jones","1690","Jones",1607323,40990,430406,212,0,6134,131761,680657,137895,818552,5989
"G1301750","1860","Georgia","130","Laurens","1750","Laurens",1616319,36692,342244,715,20,10654,77600,513409,88254,601663,3269
"G1301770","1860","Georgia","130","Lee","1770","Lee",2140429,82433,383470,380,0,24514,118771,911957,143285,1055242,4947
"G1301790","1860","Georgia","130","Liberty","1790","Liberty",617592,51131,306398,0,0,85,42302,338252,42387,380639,6083
"G1301810","1860","Georgia","130","Lincoln","1810","Lincoln",782140,41203,198505,22,0,5530,69458,265579,74988,340567,3768
"G1301850","1860","Georgia","130","Lowndes","1850","Lowndes",1258205,44110,313774,0,0,11298,79172,313381,90470,403851,2399
"G1301870","1860","Georgia","130","Lumpkin","1870","Lumpkin",331295,18150,109628,3097,1566,9146,38789,90954,47935,138889,432
"G1301910","1860","Georgia","130","McIntosh","1910","Mcintosh",892061,68476,123611,0,0,0,13230,237114,13230,250344,4063
"G1301930","1860","Georgia","130","Macon","1930","Macon",1680768,51624,377766,75,5,8491,118975,728878,127466,856344,4865
"G1301950","1860","Georgia","130","Madison","1950","Madison",758797,76561,210640,0,0,96281,71814,206343,168095,374438,1992
"G1301970","1860","Georgia","130","Marion","1970","Marion",1140302,59087,320658,25,0,5390,110186,621302,115576,736878,3529
"G1301990","1860","Georgia","130","Meriwether","1990","Meriwether",2432794,152066,638240,20142,1453,30133,217981,1263643,248114,1511757,8748
"G1302010","1860","Georgia","130","Miller","2010","Miller",314595,11768,103755,0,0,3044,24548,82656,27592,110248,640
"G1302015","1860","Georgia","130","Milton","2015","Milton",327085,14558,150176,232,0,14877,47429,176055,62306,238361,617
"G1302050","1860","Georgia","130","Mitchell","2050","Mitchell",819057,34007,167375,0,0,3596,38939,246475,42535,289010,1589
"G1302070","1860","Georgia","130","Monroe","2070","Monroe",3153690,132542,757455,22661,0,16718,213466,1277493,230184,1507677,10177
"G1302090","1860","Georgia","130","Montgomery","2090","Montgomery",389038,18981,239350,0,0,18763,40947,90164,59710,149874,977
"G1302110","1860","Georgia","130","Morgan","2110","Morgan",1394573,62980,358864,0,0,1880,104944,600503,106824,707327,7006
"G1302130","1860","Georgia","130","Murray","2130","Murray",1254805,33358,217629,159,47,40959,66251,258756,107210,365966,1442
"G1302150","1860","Georgia","130","Muscogee","2150","Muscogee",1514052,96334,306269,5117,6790,563,84212,500880,84775,585655,7445
"G1302170","1860","Georgia","130","Newton","2170","Newton",1885836,92871,509162,100,63,30030,150093,677957,180123,858080,6458
"G1302210","1860","Georgia","130","Oglethorpe","2210","Oglethorpe",1766381,74107,367620,0,0,10510,124652,637211,135162,772373,7514
"G1302230","1860","Georgia","130","Paulding","2230","Paulding",671708,28822,185305,90,330,14118,55343,263163,69461,332624,572
"G1302270","1860","Georgia","130","Pickens","2270","Pickens",384292,22457,118708,85,558,16973,38019,125536,54992,180528,246
"G1302290","1860","Georgia","130","Pierce","2290","Pierce",208710,7479,119267,1390,0,4047,23007,52005,27054,79059,233
"G1302310","1860","Georgia","130","Pike","2310","Pike",1485948,60594,371895,2499,11,11250,109259,620411,120509,740920,4722
"G1302330","1860","Georgia","130","Polk","2330","Polk",1331713,49640,235739,0,0,10739,72191,479874,82930,562804,2440
"G1302350","1860","Georgia","130","Pulaski","2350","Pulaski",1485870,76617,367472,600,50,4037,118881,585210,122918,708128,4106
"G1302370","1860","Georgia","130","Putnam","2370","Putnam",1663088,109961,415132,0,1,3995,143085,770667,147080,917747,7138
"G1302390","1860","Georgia","130","Quitman","2390","Quitman",574730,20488,143347,10,0,1208,34179,291339,35387,326726,1625
"G1302410","1860","Georgia","130","Rabun","2410","Rabun",274926,15422,119519,4531,0,7511,29297,70616,36808,107424,206
"G1302430","1860","Georgia","130","Randolph","2430","Randolph",1443698,78879,345700,50,0,2034,105459,745435,107493,852928,4467
"G1302450","1860","Georgia","130","Richmond","2450","Richmond",2105079,62911,417325,12031,59310,404,135705,372668,136109,508777,8389
"G1302490","1860","Georgia","130","Schley","2490","Schley",737130,31130,183468,2857,0,3103,63275,390466,66378,456844,2348
"G1302510","1860","Georgia","130","Screven","2510","Screven",1444732,73653,366736,145,215,5765,79038,431164,84803,515967,4530
"G1302550","1860","Georgia","130","Spalding","2550","Spalding",989600,45589,270546,280,200,4546,70257,359949,74803,434752,3819
"G1302590","1860","Georgia","130","Stewart","2590","Stewart",2502959,123214,651516,6316,0,4890,151423,1607455,156313,1763768,7884
"G1302610","1860","Georgia","130","Sumter","2610","Sumter",2319466,126202,468969,266,618,8732,118637,944960,127369,1072329,4890
"G1302630","1860","Georgia","130","Talbot","2630","Talbot",1957372,88197,515656,0,282,6877,94607,1091917,101484,1193401,8603
"G1302650","1860","Georgia","130","Taliaferro","2650","Taliaferro",661670,26141,157350,1005,0,4042,50288,246789,54330,301119,2849
"G1302670","1860","Georgia","130","Tattnall","2670","Tattnall",305905,26762,280841,0,0,10800,87083,151505,97883,249388,1157
"G1302690","1860","Georgia","130","Taylor","2690","Taylor",1078678,40513,228600,42,27,8642,82086,404995,90728,495723,2397
"G1302710","1860","Georgia","130","Telfair","2710","Telfair",295795,14092,150355,2505,0,7241,36401,131508,43642,175150,836
"G1302730","1860","Georgia","130","Terrell","2730","Terrell",1202955,39443,252689,0,0,24009,66422,448097,90431,538528,2888
"G1302750","1860","Georgia","130","Thomas","2750","Thomas",1530540,75757,360249,0,0,32875,112365,585434,145240,730674,6244
"G1302810","1860","Georgia","130","Towns","2810","Towns",260662,2797,104413,1020,0,13357,25701,69092,39058,108150,108
"G1302850","1860","Georgia","130","Troup","2850","Troup",2196064,92230,484163,105,61,2742,175524,1199568,178266,1377834,10002
"G1302890","1860","Georgia","130","Twiggs","2890","Twiggs",1535777,48074,388418,257,0,4832,114140,877485,118972,996457,5318
"G1302910","1860","Georgia","130","Union","2910","Union",352560,18221,130172,45,1854,14794,33298,107896,48092,155988,116
"G1302930","1860","Georgia","130","Upson","2930","Upson",1413869,68447,394390,3710,12,12403,143741,692443,156144,848587,4888
"G1302950","1860","Georgia","130","Walker","2950","Walker",1469831,59124,575862,0,0,14200,101646,409574,115846,525420,1535
"G1302970","1860","Georgia","130","Walton","2970","Walton",1342409,51476,384810,1444,0,20376,113617,517439,133993,651432,4621
"G1302990","1860","Georgia","130","Ware","2990","Ware",381571,10014,114997,205,40,3757,29246,51229,33003,84232,377
"G1303010","1860","Georgia","130","Warren","3010","Warren",1525824,56568,329594,0,0,7979,116102,630934,124081,755015,5379
"G1303030","1860","Georgia","130","Washington","3030","Washington",2358562,100892,572166,0,0,26461,184862,890664,211323,1101987,6532
"G1303050","1860","Georgia","130","Wayne","3050","Wayne",145633,8491,98554,0,0,1421,20683,47268,22104,69372,621
"G1303070","1860","Georgia","130","Webster","3070","Webster",852642,39384,212803,2230,0,2390,67533,458264,69923,528187,2287
"G1303110","1860","Georgia","130","White","3110","White",326872,16827,108413,3066,3497,11144,25839,91407,36983,128390,263
"G1303130","1860","Georgia","130","Whitfield","3130","Whitfield",1546585,49977,265500,80,200,10432,83153,250549,93585,344134,1732
"G1303150","1860","Georgia","130","Wilcox","3150","Wilcox",285977,16066,125949,10,0,9991,36645,95686,46636,142322,421
"G1303170","1860","Georgia","130","Wilkes","3170","Wilkes",1601158,71517,364196,60,150,5184,126694,638533,131878,770411,7953
"G1303190","1860","Georgia","130","Wilkinson","3190","Wilkinson",1974014,72025,455221,12256,0,11915,132254,806295,144169,950464,3887
"G1303210","1860","Georgia","130","Worth","3210","Worth",527872,18054,181840,882,0,8448,45430,160879,53878,214757,632
"G1700010","1860","Illinois","170","Adams","0010","ADAMS",9228170,268950,1302857,30798,1970,4296,468374,1804838,472670,2277508,
"G1700030","1860","Illinois","170","Alexander","0030","Alexander",305710,21890,79846,0,0,0,0,82722,0,82722,
"G1700050","1860","Illinois","170","Bond","0050","Bond",1689845,62704,353916,13064,200,5971,93161,412856,99132,511988,
"G1700070","1860","Illinois","170","Boone","0070","Boone",3085040,216629,458578,1290,3619,55,86240,797039,86295,883334,
"G1700090","1860","Illinois","170","Brown","0090","Brown",2084951,88263,475430,14084,208,21687,183534,546776,205221,751997,
"G1700110","1860","Illinois","170","Bureau","0110","Bureau",8557220,342940,1294258,18340,19950,125,240345,2137625,240470,2378095,
"G1700130","1860","Illinois","170","Calhoun","0130","Calhoun",669390,38750,163885,5495,1745,1590,43988,187815,45578,233393,
"G1700150","1860","Illinois","170","Carroll","0150","Carroll",2843417,135852,503805,2488,3984,628,91411,1027254,92039,1119293,
"G1700170","1860","Illinois","170","Cass","0170","Cass",4260382,139213,649730,2873,2880,3568,264030,975752,267598,1243350,
"G1700190","1860","Illinois","170","Champaign","0190","Champaign",5013180,164352,773313,6867,4934,3624,254420,1261661,258044,1519705,
"G1700210","1860","Illinois","170","Christian","0210","Christian",2632005,131484,600145,2344,186,2823,89687,865096,92510,957606,
"G1700230","1860","Illinois","170","Clark","0230","Clark",2507566,111682,568933,9657,252,17839,115549,702497,133388,835885,
"G1700250","1860","Illinois","170","Clay","0250","Clay",2745904,110469,590484,7756,366,16344,98963,530344,115307,645651,
"G1700270","1860","Illinois","170","Clinton","0270","Clinton",4073548,160203,739741,6794,282,75,85568,757165,85643,842808,
"G1700290","1860","Illinois","170","Coles","0290","Coles",4112628,134243,847989,7769,3153,7355,189280,1205698,196635,1402333,
"G1700310","1860","Illinois","170","Cook","0310","Cook",10005774,394693,1250694,7373,51005,1112,110834,2445587,111946,2557533,
"G1700330","1860","Illinois","170","Crawford","0330","Crawford",1742235,78143,518004,12606,50,23376,154464,566540,177840,744380,
"G1700350","1860","Illinois","170","Cumberland","0350","Cumberland",1063700,40418,193226,2039,203,7349,30666,279618,38015,317633,
"G1700370","1860","Illinois","170","DeKalb","0370","De Kalb",5596102,350739,927988,2758,370,1448,166921,1698658,168369,1867027,
"G1700390","1860","Illinois","170","De Witt","0390","De Witt",3526751,170068,628313,11367,580,3583,227363,888110,230946,1119056,
"G1700410","1860","Illinois","170","Douglas","0410","Douglas",2384660,82807,514952,1159,320,1209,54025,755096,55234,810330,
"G1700430","1860","Illinois","170","Dupage","0430","Du Page",5128274,204110,748297,14165,2809,628,126192,1228516,126820,1355336,
"G1700450","1860","Illinois","170","Edgar","0450","Edgar",5662398,225892,1180482,22301,1496,15040,147820,1327824,162860,1490684,
"G1700470","1860","Illinois","170","Edwards","0470","Edwards",968015,56777,232985,7105,0,6392,62634,273756,69026,342782,
"G1700490","1860","Illinois","170","Effingham","0490","Effingham",1415593,62178,268671,4663,473,6681,74792,304405,81473,385878,
"G1700510","1860","Illinois","170","Fayette","0510","Fayette",1824588,75829,367546,10894,390,13820,106087,421393,119907,541300,
"G1700530","1860","Illinois","170","Ford","0530","Ford",466616,10183,43876,50,5,60,6539,66298,6599,72897,
"G1700550","1860","Illinois","170","Franklin","0550","Franklin",1567095,71725,500086,11869,195,22693,88804,438037,111497,549534,
"G1700570","1860","Illinois","170","Fulton","0570","Fulton",8358867,343659,1415686,30974,1714,26266,529300,2198647,555566,2754213,
"G1700590","1860","Illinois","170","Gallatin","0590","Gallatin",1348915,47979,287268,6377,5064,5342,76810,341278,82152,423430,
"G1700610","1860","Illinois","170","Greene","0610","Greene",4606965,160737,898808,8384,255,16409,122411,838199,138820,977019,
"G1700630","1860","Illinois","170","Grundy","0630","Grundy",2573250,99931,453082,475,3384,0,52392,657267,52392,709659,
"G1700650","1860","Illinois","170","Hamilton","0650","Hamilton",1233170,45087,364832,10663,280,25538,68709,342096,94247,436343,
"G1700670","1860","Illinois","170","Hancock","0670","Hancock",7065584,262703,1103378,28522,4466,9061,298277,1466437,307338,1773775,
"G1700690","1860","Illinois","170","Hardin","0690","Hardin",442910,17651,103409,2365,155,3126,23812,165071,26938,192009,
"G1700710","1860","Illinois","170","Henderson","0710","Henderson",3334410,144642,699489,15741,24012,1936,182143,1105763,184079,1289842,
"G1700730","1860","Illinois","170","Henry","0730","Henry",5274000,246864,968789,1270,1200,6040,149193,1597367,155233,1752600,
"G1700750","1860","Illinois","170","Iroquois","0750","Iroquois",3035168,130865,649640,3605,910,2568,86910,737035,89478,826513,
"G1700770","1860","Illinois","170","Jackson","0770","Jackson",1602730,70839,354225,36003,9793,8875,117674,392446,126549,518995,
"G1700790","1860","Illinois","170","Jasper","0790","Jasper",1997452,96510,434315,4935,804,18716,68627,422425,87343,509768,
"G1700810","1860","Illinois","170","Jefferson","0810","Jefferson",1892813,109359,704293,30174,9000,28518,123571,603686,152089,755775,
"G1700830","1860","Illinois","170","Jersey","0830","Jersey",3534524,191330,558934,14869,750,705,97876,730789,98581,829370,
"G1700850","1860","Illinois","170","Jo Daviess","0850","Jo Daviess",4761240,223103,712908,12089,11525,61812,220732,1066170,282544,1348714,
"G1700870","1860","Illinois","170","Johnson","0870","Johnson",1070845,51961,350258,20361,9198,27260,81885,481777,109145,590922,
"G1700890","1860","Illinois","170","Kane","0890","Kane",7799711,331679,1065681,17712,3068,5942,219610,1535554,225552,1761106,
"G1700910","1860","Illinois","170","Kankakee","0910","Kankakee",3738297,184789,728373,2956,3939,1507,124715,897189,126222,1023411,
"G1700930","1860","Illinois","170","Kendall","0930","Kendall",4955320,317527,827356,915,200,0,138147,1120087,138147,1258234,
"G1700950","1860","Illinois","170","Knox","0950","Knox",6996699,320648,1508794,15691,2092,5202,203440,2288173,208642,2496815,
"G1700970","1860","Illinois","170","Lake","0970","La Salle",4881604,209113,707963,4097,632,2068,91063,1031114,93131,1124245,
"G1700990","1860","Illinois","170","La Salle","0990","Lake",7715294,264495,1224526,3145,3603,10,177966,1421466,177976,1599442,
"G1701010","1860","Illinois","170","Lawrence","1010","Lawrence",1898935,92365,362328,14764,1851,12003,94792,426864,106795,533659,
"G1701030","1860","Illinois","170","Lee","1030","Lee",4860834,257286,804870,4899,11965,40,106219,1285757,106259,1392016,
"G1701050","1860","Illinois","170","Livingston","1050","Livingston",3430450,125098,576493,1512,517,1784,70883,809847,72667,882514,
"G1701070","1860","Illinois","170","Logan","1070","Logan",4889350,206093,926035,12273,950,3036,96516,1553089,99552,1652641,
"G1701090","1860","Illinois","170","McDonough","1090","Mcdonough",4360424,163487,757058,15535,537,6452,139129,1227774,145581,1373355,
"G1701110","1860","Illinois","170","McHenry","1110","Mchenry",6753880,299702,1043608,7779,1378,2827,133392,1440562,136219,1576781,
"G1701130","1860","Illinois","170","McLean","1130","Mclean",8258690,298586,1379757,9019,2093,544,221182,2207159,221726,2428885,
"G1701150","1860","Illinois","170","Macon","1150","Macon",4336640,198850,794695,1540,3075,265,197109,973268,197374,1170642,
"G1701170","1860","Illinois","170","Macoupin","1170","Macoupin",6481325,293692,1277298,17709,3462,13151,393937,1420387,407088,1827475,
"G1701190","1860","Illinois","170","Madison","1190","Madison",6052957,248059,1143064,40436,8858,2106,366550,1399295,368656,1767951,
"G1701210","1860","Illinois","170","Marion","1210","Marion",3054215,82342,591116,1396,20,2002,60847,533994,62849,596843,
"G1701230","1860","Illinois","170","Marshall","1230","Marshall",4238975,199762,693387,13599,1088,244,108693,1105602,108937,1214539,
"G1701250","1860","Illinois","170","Mason","1250","Mason",3029529,215869,644660,705,244,1507,105335,1126630,106842,1233472,
"G1701270","1860","Illinois","170","Massac","1270","Massac",689940,47005,181481,6530,10550,24007,54198,233325,78205,311530,
"G1701290","1860","Illinois","170","Menard","1290","Menard",3466631,141786,771731,8221,1906,27100,81849,872049,108949,980998,
"G1701310","1860","Illinois","170","Mercer","1310","Mercer",4751115,234282,1042551,13820,2158,16512,103144,1534792,119656,1654448,
"G1701330","1860","Illinois","170","Monroe","1330","Monroe",3005870,138451,586422,2035,100,0,15813,697697,15813,713510,
"G1701350","1860","Illinois","170","Montgomery","1350","Montgomery",3336107,168461,746364,10724,668,9753,172138,688055,181891,869946,
"G1701370","1860","Illinois","170","Morgan","1370","Morgan",9019910,237832,1411490,11848,20220,4733,658252,1496959,662985,2159944,
"G1701390","1860","Illinois","170","Moultrie","1390","Moultrie",1854963,73844,406385,5741,295,8959,45605,588554,54564,643118,
"G1701410","1860","Illinois","170","Ogle","1410","Ogle",8226291,388471,1353405,9096,3253,1319,216164,2194949,217483,2412432,
"G1701430","1860","Illinois","170","Peoria","1430","Peoria",6812219,314944,1227978,21307,14688,1260,298957,1846115,300217,2146332,
"G1701450","1860","Illinois","170","Perry","1450","Perry",2256945,106188,566222,5681,55,4405,60323,332470,64728,397198,
"G1701470","1860","Illinois","170","Piatt","1470","Piatt",2744850,68852,433870,1050,0,320,0,826268,320,826588,
"G1701490","1860","Illinois","170","Pike","1490","Pike",6570936,237939,1162590,17229,385,10408,403126,1574436,413534,1987970,
"G1701510","1860","Illinois","170","Pope","1510","Pope",720814,36089,221512,8650,129,9998,57731,261661,67729,329390,
"G1701530","1860","Illinois","170","Pulaski","1530","Pulaski",317939,14382,70234,2061,2070,356,17347,75329,17703,93032,
"G1701550","1860","Illinois","170","Putnam","1550","Putnam",1882336,69817,328070,10421,784,124,47388,462384,47512,509896,
"G1701570","1860","Illinois","170","Randolph","1570","Randolph",3345607,157073,721025,12369,2194,4148,124001,778850,128149,906999,
"G1701590","1860","Illinois","170","Richland","1590","Richland",1454060,54053,217916,7667,120,9504,60893,262569,70397,332966,
"G1701610","1860","Illinois","170","Rock Island","1610","Rock Island",3757900,175750,668232,16448,11459,2349,147226,1109054,149575,1258629,
"G1701630","1860","Illinois","170","St Clair","1630","St Clair",10721968,490737,1242462,57043,26464,21103,225445,1961518,246548,2208067,
"G1701650","1860","Illinois","170","Saline","1650","Saline",1243220,45815,339661,9745,447,44670,99419,423737,144089,567826,
"G1701670","1860","Illinois","170","Sangamon","1670","Sangamon",11866486,307108,1926254,18328,3155,5115,579160,2226547,584275,2810822,
"G1701690","1860","Illinois","170","Schuyler","1690","Schuyler",2670885,93882,490903,9410,177,6004,161600,625844,167604,793448,
"G1701710","1860","Illinois","170","Scott","1710","Scott",2649477,88387,455667,7920,128,890,202973,536599,203863,740462,
"G1701730","1860","Illinois","170","Shelby","1730","Shelby",4224487,153112,950407,4883,2667,19650,69490,1006825,89140,1095965,
"G1701750","1860","Illinois","170","Stark","1750","Stark",2979105,175337,393248,3023,200,653,122319,788175,122972,911147,
"G1701770","1860","Illinois","170","Stephenson","1770","Stephenson",7016265,306046,960577,3707,4871,1277,183801,1774170,185078,1959248,
"G1701790","1860","Illinois","170","Tazewell","1790","Tazewell",7198430,352047,1227511,19486,1702,3042,320930,1795921,323972,2119893,
"G1701810","1860","Illinois","170","Union","1810","Union",1789223,93448,351629,32894,7784,15262,83381,496617,98643,595260,
"G1701830","1860","Illinois","170","Vermilion","1830","Vermilion",6900813,221026,1214677,17286,13169,16052,183515,1299785,199567,1499352,
"G1701850","1860","Illinois","170","Wabash","1850","Wabash",1259800,63550,253142,11214,4493,8229,71047,319657,79276,398933,
"G1701870","1860","Illinois","170","Warren","1870","Warren",6448857,243640,1123231,5250,143,4252,127426,1999735,131678,2131413,
"G1701890","1860","Illinois","170","Washington","1890","Washington",3806752,171206,790193,9340,552,7884,117526,831763,125410,957173,
"G1701910","1860","Illinois","170","Wayne","1910","Wayne",1577743,68384,394967,16626,136,22000,94401,449994,116401,566395,
"G1701930","1860","Illinois","170","White","1930","White",2267274,86945,504940,14007,646,21910,141916,578035,163826,741861,
"G1701950","1860","Illinois","170","Whiteside","1950","Whiteside",5308231,292047,868659,12445,1969,3313,122752,1409461,126065,1535526,
"G1701970","1860","Illinois","170","Will","1970","Will",6824080,258066,1013059,5475,10465,679,173726,1683970,174405,1858375,
"G1701990","1860","Illinois","170","Williamson","1990","Williamson",1812527,83697,491387,35088,50,76043,137508,649392,213551,862943,
"G1702010","1860","Illinois","170","Winnebago","2010","Winnebago",6451329,279331,816879,5065,2868,1082,114151,1337237,115233,1452470,
"G1702030","1860","Illinois","170","Woodford","2030","Woodford",4685920,192594,679888,6796,200,16622,124254,1160520,140876,1301396,
"G1800010","1860","Indiana","180","Adams","0010","Adams",1657480,69645,302950,1669,25,7785,64023,380907,71808,452715,
"G1800030","1860","Indiana","180","Allen","0030","Allen",5270388,107248,612836,26590,6350,6113,166407,900036,172520,1072556,
"G1800050","1860","Indiana","180","Bartholomew","0050","Bartholomew",5632880,133186,772765,8382,128,9684,119703,973148,129387,1102535,
"G1800070","1860","Indiana","180","Benton","0070","Benton",1211466,12184,262698,296,0,0,2062,129128,2062,131190,
"G1800090","1860","Indiana","180","Blackford","0090","Blackford",757340,19596,10521,2714,3684,6663,30812,289391,37475,326866,
"G1800110","1860","Indiana","180","Boone","0110","Boone",4563114,133143,784494,19860,0,20850,116254,673203,137104,810307,
"G1800130","1860","Indiana","180","Brown","0130","Brown",900783,37314,176236,1711,587,7493,39378,201083,46871,247954,
"G1800150","1860","Indiana","180","Carroll","0150","Carroll",4413332,185996,595074,27022,13423,10616,152599,787682,163215,950897,
"G1800170","1860","Indiana","180","Cass","0170","Cass",4433050,135276,611227,27041,1594,6350,183038,828329,189388,1017717,
"G1800190","1860","Indiana","180","Clark","0190","Clark",4388631,110103,585665,15441,13880,10895,212285,577708,223180,800888,
"G1800210","1860","Indiana","180","Clay","0210","Clay",2469134,86681,475945,16763,179,12501,86384,456502,98885,555387,
"G1800230","1860","Indiana","180","Clinton","0230","Clinton",4595945,103624,698479,19447,0,12890,91397,1062522,104287,1166809,
"G1800250","1860","Indiana","180","Crawford","0250","Crawford",954283,41769,276783,3996,3721,9086,50110,210870,59196,270066,
"G1800270","1860","Indiana","180","Daviess","0270","Daviess",2792551,111190,512408,5893,11814,19127,130951,503693,150078,653771,
"G1800290","1860","Indiana","180","Dearborn","0290","Dearborn",5457900,169843,573584,5474,3176,1523,154007,722601,155530,878131,
"G1800310","1860","Indiana","180","Decatur","0310","Decatur",6656198,174496,915943,728,331,10789,100133,882577,110922,993499,
"G1800330","1860","Indiana","180","DeKalb","0330","De Kalb",2980858,86313,413035,12647,790,6787,83970,507709,90757,598466,
"G1800350","1860","Indiana","180","Delaware","0350","Delaware",5044006,147646,669962,17148,812,14581,168786,709430,183367,892797,
"G1800370","1860","Indiana","180","Dubois","0370","Dubois",1319575,93906,357461,6114,17,3795,68519,294622,72314,366936,
"G1800390","1860","Indiana","180","Elkhart","0390","Elkhart",6504577,184258,637031,30837,0,3835,122600,973513,126435,1099948,
"G1800410","1860","Indiana","180","Fayette","0410","Fayette",5898011,151280,650539,9828,7938,998,100774,668193,101772,769965,
"G1800430","1860","Indiana","180","Floyd","0430","Floyd",1745483,51695,212461,10493,40226,1833,45531,248686,47364,296050,
"G1800450","1860","Indiana","180","Fountain","0450","Fountain",4539201,149890,791606,30190,3147,8326,127101,1622741,135427,1758168,
"G1800470","1860","Indiana","180","Franklin","0470","Franklin",5656614,156889,672249,9048,25980,2913,137341,878640,140254,1018894,
"G1800490","1860","Indiana","180","Fulton","0490","Fulton",2340200,83116,403816,6987,3329,5087,82385,474199,87472,561671,
"G1800510","1860","Indiana","180","Gibson","0510","Gibson",3981697,168727,775216,33519,4460,27912,196445,882401,224357,1106758,
"G1800530","1860","Indiana","180","Grant","0530","Grant",3104998,99615,410486,16051,150,12539,87761,532564,100300,632864,
"G1800550","1860","Indiana","180","Greene","0550","Greene",3196695,111766,687431,8696,885,19478,99529,579706,119007,698713,
"G1800570","1860","Indiana","180","Hamilton","0570","Hamilton",5647278,173078,830923,23272,915,13706,116100,886927,129806,1016733,
"G1800590","1860","Indiana","180","Hancock","0590","Hancock",4031219,105338,517895,18968,100,10175,70397,573394,80572,653966,
"G1800610","1860","Indiana","180","Harrison","0610","Harrison",2918010,133834,537792,14053,738,13874,121216,703688,135090,838778,
"G1800630","1860","Indiana","180","Hendricks","0630","Hendricks",4771120,131529,902108,21568,413,16808,92578,701539,109386,810925,
"G1800650","1860","Indiana","180","Henry","0650","Henry",6893320,189785,827108,38836,32,6214,128919,877622,135133,1012755,
"G1800670","1860","Indiana","180","Howard","0670","Howard",2514795,84047,373847,5403,1390,10182,68953,479040,79135,558175,
"G1800690","1860","Indiana","180","Huntington","0690","Huntington",3405861,104255,443867,10794,0,8838,96083,513028,104921,617949,
"G1800710","1860","Indiana","180","Jackson","0710","Jackson",4336566,138762,702622,1581,5648,15314,206861,702075,222175,924250,
"G1800730","1860","Indiana","180","Jasper","0730","Jasper",1103119,36075,270630,2217,4239,2516,30881,242762,33397,276159,
"G1800750","1860","Indiana","180","Jay","0750","Jay",2600610,74044,389117,8602,261,15334,66581,448087,81915,530002,
"G1800770","1860","Indiana","180","Jefferson","0770","Jefferson",4870570,135968,725237,10541,12278,12736,131738,462130,144474,606604,
"G1800790","1860","Indiana","180","Jennings","0790","Jennings",2003454,57597,347739,1902,349,12109,77569,385440,89678,475118,
"G1800810","1860","Indiana","180","Johnson","0810","Johnson",6245805,153252,859074,25548,1382,14187,120340,863941,134527,998468,
"G1800830","1860","Indiana","180","Knox","0830","Knox",2316234,102613,475164,9703,1730,8894,112513,506937,121407,628344,
"G1800850","1860","Indiana","180","Kosciusko","0850","Kosciusko",4084327,132199,659438,19325,316,11429,125667,783418,137096,920514,
"G1800870","1860","Indiana","180","Lagrange","0870","Lagrange",3667472,111993,478262,16116,2632,2330,74867,708490,77197,785687,
"G1800890","1860","Indiana","180","Lake","0890","Lake",2057788,85316,359830,3526,154,623,59219,554597,59842,614439,
"G1800910","1860","Indiana","180","LaPorte","0910","Laporte",6415512,148480,523706,17957,3207,601,84293,966419,84894,1051313,
"G1800930","1860","Indiana","180","Lawrence","0930","Lawrence",3846524,113847,802791,5925,100,16897,224545,528049,241442,769491,
"G1800950","1860","Indiana","180","Madison","0950","Madison",5061358,143221,592402,16627,2235,13908,119130,760175,133038,893213,
"G1800970","1860","Indiana","180","Marion","0970","Marion",10923440,219976,975461,48175,41395,6449,153894,1192594,160343,1352937,
"G1800990","1860","Indiana","180","Marshall","0990","Marshall",1692420,36503,167942,8150,3578,4419,35148,279082,39567,318649,
"G1801010","1860","Indiana","180","Martin","1010","Martin",1137620,47262,280576,1473,3950,11073,62287,235501,73360,308861,
"G1801030","1860","Indiana","180","Miami","1030","Miami",4470525,137817,567322,18000,617,11047,153347,752961,164394,917355,
"G1801050","1860","Indiana","180","Monroe","1050","Monroe",3054156,95673,617916,10673,252,16291,82183,461510,98474,559984,
"G1801070","1860","Indiana","180","Montgomery","1070","Montgomery",7807182,297606,1225862,37766,4716,15511,152563,990145,168074,1158219,
"G1801090","1860","Indiana","180","Morgan","1090","Morgan",5767548,138935,934987,19942,1060,23459,110085,871904,133544,1005448,
"G1801110","1860","Indiana","180","Newton","1110","Newton",964571,23692,182783,0,0,0,0,75355,0,75355,
"G1801130","1860","Indiana","180","Noble","1130","Noble",3242207,97306,428949,15889,2477,5575,100635,659848,106210,766058,
"G1801150","1860","Indiana","180","Ohio","1150","Ohio",2026760,19786,143177,2792,2588,2673,45492,280818,48165,328983,
"G1801170","1860","Indiana","180","Orange","1170","Orange",2458913,95548,514353,8384,1374,18398,176974,352993,195372,548365,
"G1801190","1860","Indiana","180","Owen","1190","Owen",3530527,112527,572741,10975,411,17049,74652,643116,91701,734817,
"G1801210","1860","Indiana","180","Parke","1210","Parke",5081953,154013,788475,21175,2633,6921,117433,910455,124354,1034809,
"G1801230","1860","Indiana","180","Perry","1230","Perry",1098473,37218,222650,6533,1560,4779,63036,222329,67815,290144,
"G1801250","1860","Indiana","180","Pike","1250","Pike",1656220,78781,413491,7313,101311,15338,120596,506841,135934,642775,
"G1801270","1860","Indiana","180","Porter","1270","Porter",3307780,85615,417486,11204,1480,480,63157,570957,63637,634594,
"G1801290","1860","Indiana","180","Posey","1290","Posey",3786096,47954,407131,9186,566,3547,259163,636588,262710,899298,
"G1801310","1860","Indiana","180","Pulaski","1310","Pulaski",1065376,33746,218698,686,3,2929,29727,268796,32656,301452,
"G1801330","1860","Indiana","180","Putnam","1330","Putnam",7755634,183021,1453638,36553,1094,19184,143058,972564,162242,1134806,
"G1801350","1860","Indiana","180","Randolph","1350","Randolph",5852796,161692,739910,26280,619,17554,115752,701795,133306,835101,
"G1801370","1860","Indiana","180","Ripley","1370","Ripley",3702062,119642,589805,9008,190,12270,104243,787567,116513,904080,
"G1801390","1860","Indiana","180","Rush","1390","Rush",10266642,222793,1178960,30840,6827,6319,166846,1198014,173165,1371179,
"G1801410","1860","Indiana","180","St Joseph","1410","St Joseph",4216875,131434,443176,22491,8912,1848,103858,855055,105706,960761,
"G1801430","1860","Indiana","180","Scott","1430","Scott",1176590,42711,282261,1888,64,14829,39668,201441,54497,255938,
"G1801450","1860","Indiana","180","Shelby","1450","Shelby",7790350,199049,979394,22227,800,118906,118118,1110177,237024,1347201,
"G1801470","1860","Indiana","180","Spencer","1470","Spencer",2796195,107490,473153,13296,280,9453,108702,588057,118155,706212,
"G1801490","1860","Indiana","180","Starke","1490","Starke",411650,15245,76538,342,199,669,10681,80372,11350,91722,
"G1801510","1860","Indiana","180","Steuben","1510","Steuben",2426995,82715,452116,14851,1140,6656,72247,560842,78903,639745,
"G1801530","1860","Indiana","180","Sullivan","1530","Sullivan",2548305,107723,556967,16218,310,20853,118313,527824,139166,666990,
"G1801550","1860","Indiana","180","Switzerland","1550","Switzerland",4508776,133965,468768,6851,7795,12096,75056,570658,87152,657810,
"G1801570","1860","Indiana","180","Tippecanoe","1570","Tippecanoe",8257600,198864,1126764,29400,9960,1886,297138,1247904,299024,1546928,
"G1801590","1860","Indiana","180","Tipton","1590","Tipton",2026633,46879,334348,1596,130,9198,41365,303757,50563,354320,
"G1801610","1860","Indiana","180","Union","1610","Union",4356027,145129,509743,4991,4321,20,52287,455767,52307,508074,
"G1801630","1860","Indiana","180","Vanderburgh","1630","Vanderburgh",1912594,54582,296738,9046,5139,1703,74514,326499,76217,402716,
"G1801650","1860","Indiana","180","Vermillion","1650","Vermillion",2477892,92846,490569,7549,9691,8884,133778,557322,142662,699984,
"G1801670","1860","Indiana","180","Vigo","1670","Vigo",3958905,114459,638243,11284,9454,6847,145605,789850,152452,942302,
"G1801690","1860","Indiana","180","Wabash","1690","Wabash",4913676,159729,711595,20118,1352,18225,170935,900388,189160,1089548,
"G1801710","1860","Indiana","180","Warren","1710","Warren",3915395,102453,735715,12376,160,2965,73869,600900,76834,677734,
"G1801730","1860","Indiana","180","Warrick","1730","Warrick",3066049,103017,519780,14421,0,17353,107134,593671,124487,718158,
"G1801750","1860","Indiana","180","Washington","1750","Washington",4283381,175839,894141,17168,325,18709,182658,682890,201367,884257,
"G1801770","1860","Indiana","180","Wayne","1770","Wayne",11583148,309023,1145864,29643,12383,6487,165132,1146435,171619,1318054,
"G1801790","1860","Indiana","180","Wells","1790","Wells",2393249,68794,367262,5456,9820,9635,99389,452807,109024,561831,
"G1801810","1860","Indiana","180","White","1810","White",2864063,79606,461186,3596,370,3470,62068,428525,65538,494063,
"G1801830","1860","Indiana","180","Whitley","1830","Whitley",2921596,77611,390452,7088,100,7307,82683,460068,89990,550058,
"G1900010","1860","Iowa","190","Adair","0010","Adair",201680,7662,37690,0,0,435,7139,54949,7574,62523,
"G1900030","1860","Iowa","190","Adams","0030","Adams",225650,12049,62247,0,0,1495,8681,82987,10176,93163,
"G1900050","1860","Iowa","190","Allamakee","0050","Allamakee",1722740,76087,291468,60,325,1200,80311,539015,81511,620526,
"G1900070","1860","Iowa","190","Appanoose","0070","Appanoose",2240170,106549,504890,535,434,21253,117812,654657,139065,793722,
"G1900090","1860","Iowa","190","Audubon","0090","Audubon",141597,3655,20181,0,0,502,3470,29231,3972,33203,
"G1900110","1860","Iowa","190","Benton","0110","Benton",1903648,80374,326732,9,120,3554,48462,536585,52016,588601,
"G1900130","1860","Iowa","190","Black Hawk","0130","Black Hawk",1369995,63922,220187,0,3746,842,29579,397702,30421,428123,
"G1900150","1860","Iowa","190","Boone","0150","Boone",638892,31373,149726,0,0,6898,24010,241504,30908,272412,
"G1900170","1860","Iowa","190","Bremer","0170","Bremer",1031330,48058,170371,17,50,1043,22325,285382,23368,308750,
"G1900190","1860","Iowa","190","Buchanan","0190","Buchanan",1456513,57360,241924,20,1060,1577,33241,393105,34818,427923,
"G1900210","1860","Iowa","190","Buena Vista","0210","Buena Vista",2400,90,5600,0,0,0,60,988,60,1048,
"G1900215","1860","Iowa","190","Buncombe","0215","Buncombe",,,,,,,,,,,
"G1900230","1860","Iowa","190","Butler","0230","Butler",499875,27632,101497,0,0,666,17856,215949,18522,234471,
"G1900250","1860","Iowa","190","Calhoun","0250","Calhoun",24960,715,4844,0,0,0,1347,9880,1347,11227,
"G1900270","1860","Iowa","190","Carroll","0270","Carroll",28250,1547,7842,0,429,55,1350,14194,1405,15599,
"G1900290","1860","Iowa","190","Cass","0290","Cass",324324,15527,70030,0,2203,702,9515,111718,10217,121935,
"G1900310","1860","Iowa","190","Cedar","0310","Cedar",3691875,158681,685074,2520,447,6295,160127,1092955,166422,1259377,
"G1900330","1860","Iowa","190","Cerro Gordo","0330","Cerro Gordo",176286,10990,39875,0,0,0,11799,58235,11799,70034,
"G1900350","1860","Iowa","190","Cherokee","0350","Cherokee",2950,250,1450,0,0,0,150,1336,150,1486,
"G1900370","1860","Iowa","190","Chickasaw","0370","Chickasaw",562685,31738,125421,0,0,234,25861,260674,26095,286769,
"G1900390","1860","Iowa","190","Clarke","0390","Clarke",911039,43327,194829,0,0,4697,29468,289069,34165,323234,
"G1900410","1860","Iowa","190","Clay","0410","Clay",6000,400,2075,0,0,0,350,2050,350,2400,
"G1900430","1860","Iowa","190","Clayton","0430","Clayton",3147582,161186,475936,127,292,1029,125769,969763,126798,1096561,
"G1900450","1860","Iowa","190","Clinton","0450","Clinton",3366065,175419,600892,316,5670,157,95243,1158529,95400,1253929,
"G1900470","1860","Iowa","190","Crawford","0470","Crawford",57430,3188,13450,0,555,0,2960,22001,2960,24961,
"G1900490","1860","Iowa","190","Dallas","0490","Dallas",1225211,44867,232034,33,32,5601,30325,274644,35926,310570,
"G1900510","1860","Iowa","190","Davis","0510","Davis",2494091,119621,578795,477,238,19383,123899,672603,143282,815885,
"G1900530","1860","Iowa","190","Decatur","0530","Decatur",1556970,70310,334961,50,12,10981,61098,341707,72079,413786,
"G1900550","1860","Iowa","190","Delaware","0550","Delaware",1217201,86963,412085,205,368,2053,75533,666842,77586,744428,
"G1900570","1860","Iowa","190","Des Moines","0570","Des Moines",4186902,138682,667066,21934,28005,3396,153747,799143,157143,956286,
"G1900590","1860","Iowa","190","Dickinson","0590","Dickinson",9700,1020,2080,0,0,0,450,4049,450,4499,
"G1900610","1860","Iowa","190","Dubuque","0610","Dubuque",3658878,171982,559182,1247,3490,2013,135112,1040549,137125,1177674,
"G1900630","1860","Iowa","190","Emmet","0630","Emmet",2550,490,1700,0,0,0,417,3068,417,3485,
"G1900650","1860","Iowa","190","Fayette","0650","Fayette",1153102,87571,345411,10,0,1073,43298,586216,44371,630587,
"G1900670","1860","Iowa","190","Floyd","0670","Floyd",773012,14843,120645,0,0,0,23793,206492,23793,230285,
"G1900690","1860","Iowa","190","Franklin","0690","Franklin",200298,10178,43916,0,12,0,6695,69157,6695,75852,
"G1900710","1860","Iowa","190","Fremont","0710","Fremont",1175083,40543,241050,513,1523,5210,44255,238361,49465,287826,
"G1900730","1860","Iowa","190","Greene","0730","Greene",168557,9960,43877,0,1217,1033,8415,69951,9448,79399,
"G1900750","1860","Iowa","190","Grundy","0750","Grundy",200720,10935,36955,0,45,191,4612,68348,4803,73151,
"G1900770","1860","Iowa","190","Guthrie","0770","Guthrie",510130,27202,133225,40,0,1092,18830,208860,19922,228782,
"G1900790","1860","Iowa","190","Hamilton","0790","Hamilton",312375,14860,53115,0,25,0,6988,75800,6988,82788,
"G1900810","1860","Iowa","190","Hancock","0810","Hancock",38100,2305,6290,0,0,0,886,10082,886,10968,
"G1900830","1860","Iowa","190","Hardin","0830","Hardin",737827,30724,131366,0,0,1814,31147,234588,32961,267549,
"G1900850","1860","Iowa","190","Harrison","0850","Harrison",29010,25596,115837,0,1111,752,30595,197034,31347,228381,
"G1900870","1860","Iowa","190","Henry","0870","Henry",4106510,156579,589201,9290,22113,7315,144482,828711,151797,980508,
"G1900890","1860","Iowa","190","Howard","0890","Howard",615519,27402,108694,0,0,0,14872,199785,14872,214657,
"G1900910","1860","Iowa","190","Humboldt","0910","Humboldt",18730,755,5020,0,0,0,702,10397,702,11099,
"G1900930","1860","Iowa","190","Ida","0930","Ida",12060,717,2667,0,25,0,343,3257,343,3600,
"G1900950","1860","Iowa","190","Iowa","0950","Iowa",1464530,66638,301455,75,0,10190,59749,491698,69939,561637,
"G1900970","1860","Iowa","190","Jackson","0970","Jackson",3219489,162213,622530,5327,403,2328,127671,909923,129999,1039922,
"G1900990","1860","Iowa","190","Jasper","0990","Jasper",2046716,85129,402130,226,30,5964,89705,583219,95669,678888,
"G1901010","1860","Iowa","190","Jefferson","1010","Jefferson",3661566,146064,581292,6330,2530,14301,100769,686433,115070,801503,
"G1901030","1860","Iowa","190","Johnson","1030","Johnson",2436810,92647,454741,1024,3902,139,103174,805059,103313,908372,
"G1901050","1860","Iowa","190","Jones","1050","Jones",2552933,114576,481057,533,645,2083,91271,794640,93354,887994,
"G1901070","1860","Iowa","190","Keokuk","1070","Keokuk",3204065,119164,609124,1708,4500,8392,79078,711607,87470,799077,
"G1901090","1860","Iowa","190","Kossuth","1090","Kossuth",38010,1825,12025,0,0,0,1526,20719,1526,22245,
"G1901110","1860","Iowa","190","Lee","1110","Lee",5115505,199189,836251,20239,10504,4489,201072,984872,205561,1190433,
"G1901130","1860","Iowa","190","Linn","1130","Linn",3845262,151222,607695,1510,625,8522,88310,922971,96832,1019803,
"G1901150","1860","Iowa","190","Louisa","1150","Louisa",2538652,112789,479450,8129,0,1906,153605,656738,155511,812249,
"G1901170","1860","Iowa","190","Lucas","1170","Lucas",739539,42242,229786,0,0,6344,58282,314625,64626,379251,
"G1901210","1860","Iowa","190","Madison","1210","Madison",617460,77212,310132,402,28061,7708,46113,484640,53821,538461,
"G1901230","1860","Iowa","190","Mahaska","1230","Mahaska",2476356,106951,511361,2954,1999,10088,66457,753901,76545,830446,
"G1901250","1860","Iowa","190","Marion","1250","Marion",2778960,122907,566456,821,621,15383,126960,799101,142343,941444,
"G1901270","1860","Iowa","190","Marshall","1270","Marshall",1017015,57022,216706,59,0,1552,32490,348413,34042,382455,
"G1901290","1860","Iowa","190","Mills","1290","Mills",1330710,59919,202124,136,143,7808,61866,301697,69674,371371,
"G1901310","1860","Iowa","190","Mitchell","1310","Mitchell",607070,33664,110070,0,0,425,18829,219891,19254,239145,
"G1901330","1860","Iowa","190","Monona","1330","Monona",92435,6610,27167,0,30,304,4679,32629,4983,37612,
"G1901350","1860","Iowa","190","Monroe","1350","Monroe",1997648,73354,324708,0,153,14145,73743,430800,87888,518688,
"G1901370","1860","Iowa","190","Montgomery","1370","Montgomery",232082,8858,50667,0,0,1010,10495,65139,11505,76644,
"G1901390","1860","Iowa","190","Muscatine","1390","Muscatine",3886294,145405,657605,5198,7231,2677,108295,984031,110972,1095003,
"G1901410","1860","Iowa","190","O Brien","1410","O Brien",800,0,350,0,0,0,50,405,50,455,
"G1901430","1860","Iowa","190","Osceola","1430","Osceola",,,,,,,,,,,
"G1901450","1860","Iowa","190","Page","1450","Page",1645890,43896,207543,150,5722,7188,37797,229549,44985,274534,
"G1901470","1860","Iowa","190","Palo Alto","1470","Palo Alto",4650,415,3125,0,0,0,315,6615,315,6930,
"G1901490","1860","Iowa","190","Plymouth","1490","Plymouth",32810,1805,8085,0,365,0,1059,11468,1059,12527,
"G1901510","1860","Iowa","190","Pocahontas","1510","Pocahontas",2700,170,2000,0,0,0,170,3383,170,3553,
"G1901530","1860","Iowa","190","Polk","1530","Polk",1892316,62274,283756,81,155,5041,47395,699897,52436,752333,
"G1901550","1860","Iowa","190","Pottawattamie","1550","Pottawattamie",424211,23565,134362,0,6169,690,22075,205888,22765,228653,
"G1901570","1860","Iowa","190","Poweshiek","1570","Poweshiek",975925,38304,215044,0,10,1268,29630,309123,30898,340021,
"G1901590","1860","Iowa","190","Ringgold","1590","Ringgold",425098,18491,99289,0,0,1439,21722,146174,23161,169335,
"G1901610","1860","Iowa","190","Sac","1610","Sac",41850,1700,7875,0,0,130,1675,10076,1805,11881,
"G1901630","1860","Iowa","190","Scott","1630","Scott",4405186,209274,616530,8576,21658,1470,121367,1400352,122837,1523189,
"G1901650","1860","Iowa","190","Shelby","1650","Shelby",127610,6541,37516,0,50,82,8410,47451,8492,55943,
"G1901670","1860","Iowa","190","Sioux","1670","Sioux",,,,,,,,,,,
"G1901690","1860","Iowa","190","Story","1690","Story",626574,30004,116260,0,20,2346,16038,192252,18384,210636,
"G1901710","1860","Iowa","190","Tama","1710","Tama",313943,18066,77664,10,0,1425,9593,94360,11018,105378,
"G1901730","1860","Iowa","190","Taylor","1730","Taylor",577647,23007,122051,150,55,3507,20875,172961,24382,197343,
"G1901750","1860","Iowa","190","Union","1750","Union",377447,19295,83659,0,0,831,9684,116143,10515,126658,
"G1901770","1860","Iowa","190","Van Buren","1770","Van Buren",2800204,123876,556185,9659,212,12454,156825,696760,169279,866039,
"G1901790","1860","Iowa","190","Wapello","1790","Wapello",2064023,61303,356279,223,100,12618,64310,532064,76928,608992,
"G1901810","1860","Iowa","190","Warren","1810","Warren",1843000,72094,351658,0,300,8489,77719,508835,86208,595043,
"G1901830","1860","Iowa","190","Washington","1830","Washington",3304843,143116,658476,7454,65,7688,121082,820468,128770,949238,
"G1901850","1860","Iowa","190","Wayne","1850","Wayne",1185586,46300,247615,0,0,8527,37550,355961,46077,402038,
"G1901870","1860","Iowa","190","Webster","1870","Webster",257465,13122,60408,0,65,150,11858,96406,12008,108414,
"G1901890","1860","Iowa","190","Winnebago","1890","Winnebago",11900,1298,3055,0,0,0,645,7695,645,8340,
"G1901910","1860","Iowa","190","Winneshiek","1910","Winneshiek",2224697,152387,439380,0,0,2008,81076,847654,83084,930738,
"G1901930","1860","Iowa","190","Woodbury","1930","Woodbury",127698,7199,34077,0,0,0,4265,27702,4265,31967,
"G1901950","1860","Iowa","190","Worth","1950","Worth",120800,8232,26970,0,0,0,3913,45972,3913,49885,
"G1901970","1860","Iowa","190","Wright","1970","Wright",49095,3815,13146,0,0,40,1414,23721,1454,25175,
"G2050015","1860","Kansas Territory","205","Allen","0015","Allen",260719,28654,146205,3,99,0,17328,43965,17328,61293,
"G2050035","1860","Kansas Territory","205","Anderson","0035","Anderson",261235,11744,73869,0,0,146,19229,44896,19375,64271,
"G2050075","1860","Kansas Territory","205","Atchison","0075","Atchison",655193,43305,157397,0,2690,604,46600,307362,47204,354566,
"G2050095","1860","Kansas Territory","205","Bourbon","0095","Bourbon",452123,54274,250852,100,100,1540,33297,103071,34837,137908,
"G2050115","1860","Kansas Territory","205","Breckinridge","0115","Breckinridge",640355,31594,147265,0,1450,725,17364,125550,18089,143639,
"G2050135","1860","Kansas Territory","205","Brown","0135","Brown",348665,25760,101867,0,50,300,19057,137998,19357,157355,
"G2050155","1860","Kansas Territory","205","Butler","0155","Butler",32300,3633,17174,0,0,0,1610,8597,1610,10207,
"G2050175","1860","Kansas Territory","205","Chase","0175","Chase",91820,5666,25144,0,0,0,3839,30119,3839,33958,
"G2050195","1860","Kansas Territory","205","Clay","0195","Clay",9200,975,4125,0,0,0,459,5137,459,5596,
"G2050215","1860","Kansas Territory","205","Coffey","0215","Coffey",344040,22875,94998,0,2,0,14825,76227,14825,91052,
"G2050255","1860","Kansas Territory","205","Davis","0255","Davis",95050,6810,16051,0,427,0,4788,51369,4788,56157,
"G2050275","1860","Kansas Territory","205","Dickinson","0275","Dickinson",8400,1580,5390,0,0,0,680,4915,680,5595,
"G2050295","1860","Kansas Territory","205","Doniphan","0295","Doniphan",801878,35123,159395,6,2674,2136,46304,259076,48440,307516,
"G2050315","1860","Kansas Territory","205","Dorn","0315","Dorn",375,380,1929,0,0,0,45,77,45,122,
"G2050335","1860","Kansas Territory","205","Douglas","0335","Douglas",1427795,68351,263101,80,700,0,41062,298890,41062,339952,
"G2050355","1860","Kansas Territory","205","Franklin","0355","Franklin",578848,25778,152275,50,2097,772,30827,150904,31599,182503,
"G2050375","1860","Kansas Territory","205","Godfrey","0375","Godfrey",,,,,,,,,,,
"G2050395","1860","Kansas Territory","205","Greenwood","0395","Greenwood",68200,4745,22800,0,1248,0,3630,20943,3630,24573,
"G2050415","1860","Kansas Territory","205","Hunter","0415","Hunter",6700,800,5565,0,0,0,345,3161,345,3506,
"G2050435","1860","Kansas Territory","205","Jackson","0435","Jackson",210900,12515,58091,0,0,0,5442,83939,5442,89381,
"G2050455","1860","Kansas Territory","205","Jefferson","0455","Jefferson",599705,26156,168595,2,626,2360,43554,187286,45914,233200,
"G2050475","1860","Kansas Territory","205","Johnson","0475","Johnson",603305,28415,125929,0,150,130,18732,152206,18862,171068,
"G2050495","1860","Kansas Territory","205","Leavenworth","0495","Leavenworth",1247410,45182,198735,0,11295,1839,36435,240892,38274,279166,
"G2050515","1860","Kansas Territory","205","Linn","0515","Linn",673153,41006,220305,100,125,6145,44432,215544,50577,266121,
"G2050535","1860","Kansas Territory","205","McGhee","0535","Mcghee",63365,14688,75003,16,0,403,9568,14375,9971,24346,
"G2050555","1860","Kansas Territory","205","Madison","0555","Madison",102800,6868,26500,0,35,0,3505,24327,3505,27832,
"G2050575","1860","Kansas Territory","205","Marion","0575","Marion",2000,80,200,0,0,0,0,145,0,145,
"G2050595","1860","Kansas Territory","205","Marshall","0595","Marshall",52900,2364,19925,0,2156,4443,1665,27633,6108,33741,
"G2050615","1860","Kansas Territory","205","Miami/Lykins","0615","Miami/Lykins",694635,37984,204900,0,35,1730,26048,174606,27778,202384,
"G2050635","1860","Kansas Territory","205","Morris","0635","Morris",111310,5757,38450,0,340,60,3088,32216,3148,35364,
"G2050655","1860","Kansas Territory","205","Nemaha","0655","Nemaha",227055,10821,73880,0,0,1335,7427,72225,8762,80987,
"G2050695","1860","Kansas Territory","205","Osage","0695","Osage",133130,12449,47127,0,1510,10,4152,45493,4162,49655,
"G2050715","1860","Kansas Territory","205","Otoe","0715","Otoe",,,,,,,,,,,
"G2050735","1860","Kansas Territory","205","Pottawatomie","0735","Pottawatomie",231475,22926,109390,0,0,0,11115,96162,11115,107277,
"G2050755","1860","Kansas Territory","205","Riley","0755","Riley",161300,9586,37445,0,845,0,7053,49038,7053,56091,
"G2050795","1860","Kansas Territory","205","Shawnee","0795","Shawnee",511700,37070,124955,0,225,0,18740,180466,18740,199206,
"G2050815","1860","Kansas Territory","205","Wabaunsee","0815","Wabaunsee",234250,16460,76068,29,0,0,8782,69755,8782,78537,
"G2050835","1860","Kansas Territory","205","Washington","0835","Washington",,,,,,,,,,,
"G2050855","1860","Kansas Territory","205","Wilson","0855","Wilson",,,,,,,,,,,
"G2050875","1860","Kansas Territory","205","Woodson","0875","Woodson",115500,8005,39535,0,2262,70,5070,35178,5140,40318,
"G2052090","1860","Kansas Territory","205","Wyandotte","2090","Wyandotte",199450,17315,42015,270,500,0,2077,37679,2077,39756,
"G2100010","1860","Kentucky","210","Adair","0010","Adair",1062283,49908,380652,985,5,20721,74773,367799,95494,463293,1602
"G2100030","1860","Kentucky","210","Allen","0030","Allen",1414413,57391,468434,1767,145,25906,83604,374952,109510,484462,1522
"G2100050","1860","Kentucky","210","Anderson","0050","Anderson",1798182,52116,491019,2368,148,15076,86277,367749,101353,469102,1357
"G2100070","1860","Kentucky","210","Ballard","0070","Ballard",2236281,65438,418742,1894,1348,10222,94924,495764,105146,600910,1718
"G2100090","1860","Kentucky","210","Barren","0090","Barren",2590583,126031,912534,8657,20598,43455,207282,802976,250737,1053713,4078
"G2100110","1860","Kentucky","210","Bath","0110","Bath",3694743,75154,1034749,1666,0,24141,118174,747550,142315,889865,2500
"G2100150","1860","Kentucky","210","Boone","0150","Boone",6386165,114808,758037,14496,4230,13447,166423,762668,179870,942538,1745
"G2100170","1860","Kentucky","210","Bourbon","0170","Bourbon",13036380,142240,2390873,18941,2795,23713,189387,1193758,213100,1406858,6767
"G2100190","1860","Kentucky","210","Boyd","0190","Boyd",610225,8558,95082,0,0,3058,20532,102716,23590,126306,156
"G2100210","1860","Kentucky","210","Boyle","0210","Boyle",3424814,77529,924779,13172,3815,18096,117160,609852,135256,745108,3279
"G2100230","1860","Kentucky","210","Bracken","0230","Bracken",2493125,87107,542271,5356,58,9415,104074,703783,113489,817272,750
"G2100250","1860","Kentucky","210","Breathitt","0250","Breathitt",452020,6627,150560,1411,0,16334,40710,136268,57044,193312,190
"G2100270","1860","Kentucky","210","Breckinridge","0270","Breckinridge",1677235,82631,500422,2902,90,16717,96737,603443,113454,716897,2340
"G2100290","1860","Kentucky","210","Bullitt","0290","Bullitt",1773744,59843,347055,2403,30,8717,82375,310279,91092,401371,1458
"G2100310","1860","Kentucky","210","Butler","0310","Butler",1073144,44143,326500,45,0,27968,73984,280076,101952,382028,770
"G2100330","1860","Kentucky","210","Caldwell","0330","Caldwell",1972031,70114,502397,1275,280,15174,123698,671221,138872,810093,2406
"G2100350","1860","Kentucky","210","Calloway","0350","Calloway",1618946,65812,469831,1134,893,28891,105042,503867,133933,637800,1492
"G2100370","1860","Kentucky","210","Campbell","0370","Campbell",2797505,61900,269974,5163,83880,1380,35204,406708,36584,443292,116
"G2100410","1860","Kentucky","210","Carroll","0410","Carroll",2008835,48534,363490,3292,1456,7988,59312,369677,67300,436977,1045
"G2100430","1860","Kentucky","210","Carter","0430","Carter",1122061,37898,310317,12817,11104,34106,70745,284761,104851,389612,309
"G2100450","1860","Kentucky","210","Casey","0450","Casey",1020700,41359,458691,43755,3988,52988,104681,395101,157669,552770,666
"G2100470","1860","Kentucky","210","Christian","0470","Christian",8914406,246719,1038803,10965,1343,28994,347803,1886420,376797,2263217,9951
"G2100490","1860","Kentucky","210","Clark","0490","Clark",6589098,93217,1692938,14331,432,20483,138816,796248,159299,955547,4762
"G2100510","1860","Kentucky","210","Clay","0510","Clay",501280,17137,211586,1280,0,11613,53873,168441,65486,233927,349
"G2100530","1860","Kentucky","210","Clinton","0530","Clinton",842066,31542,241417,1133,5,23249,46344,205993,69593,275586,258
"G2100550","1860","Kentucky","210","Crittenden","0550","Crittenden",1530405,62265,408729,3755,245,13106,84268,482917,97374,580291,939
"G2100570","1860","Kentucky","210","Cumberland","0570","Cumberland",1252562,38517,266295,2007,54,37435,76358,404098,113793,517891,1413
"G2100590","1860","Kentucky","210","Daviess","0590","Daviess",4598215,122699,777459,7234,2840,16421,201446,1132714,217867,1350581,3515
"G2100610","1860","Kentucky","210","Edmonson","0610","Edmonson",505803,27409,212889,0,0,15179,43627,164579,58806,223385,273
"G2100650","1860","Kentucky","210","Estill","0650","Estill",967549,25412,300721,2442,319,11882,64367,253731,76249,329980,507
"G2100670","1860","Kentucky","210","Fayette","0670","Fayette",13431718,138870,1819237,10659,17341,7007,250660,1259522,257667,1517189,10015
"G2100690","1860","Kentucky","210","Fleming","0690","Fleming",3127018,106637,765207,14094,1533,23614,110331,611137,133945,745082,2018
"G2100710","1860","Kentucky","210","Floyd","0710","Floyd",632430,9474,183526,2632,0,18804,48066,196909,66870,263779,147
"G2100730","1860","Kentucky","210","Franklin","0730","Franklin",2574235,63556,609623,7149,3966,7437,113062,464938,120499,585437,3384
"G2100750","1860","Kentucky","210","Fulton","0750","Fulton",1323214,33125,227137,10443,1425,11105,57282,286977,68387,355364,1078
"G2100770","1860","Kentucky","210","Gallatin","0770","Gallatin",1414627,43362,315641,6898,1313,6326,54855,335789,61181,396970,708
"G2100790","1860","Kentucky","210","Garrard","0790","Garrard",3974189,64915,1000549,10460,1735,19662,119063,2450126,138725,2588851,3578
"G2100810","1860","Kentucky","210","Grant","0810","Grant",2121321,50024,519633,3340,0,9807,65971,453255,75778,529033,696
"G2100830","1860","Kentucky","210","Graves","0830","Graves",3140260,141834,814394,7438,1378,52174,185009,1037601,237183,1274784,2845
"G2100850","1860","Kentucky","210","Grayson","0850","Grayson",986267,57654,411581,350,114,26718,83047,352447,109765,462212,351
"G2100870","1860","Kentucky","210","Green","0870","Green",1154698,44367,390029,110,76,19270,85970,448683,105240,553923,2372
"G2100890","1860","Kentucky","210","Greenup","0890","Greenup",1190619,34517,217274,6635,3049,3950,48464,249380,52414,301794,363
"G2100910","1860","Kentucky","210","Hancock","0910","Hancock",1092955,44552,258824,5637,628,10708,61547,312366,72255,384621,818
"G2100930","1860","Kentucky","210","Hardin","0930","Hardin",3456456,139354,799054,6478,32,25368,148192,825542,173560,999102,2530
"G2100950","1860","Kentucky","210","Harlan","0950","Harlan",540784,12028,184694,994,0,19027,48579,160951,67606,228557,127
"G2100970","1860","Kentucky","210","Harrison","0970","Harrison",5632940,136301,1207032,1080,3975,23508,164560,872855,188068,1060923,3289
"G2100990","1860","Kentucky","210","Hart","0990","Hart",1372929,52552,405068,680,90,19067,95142,460102,114209,574311,1395
"G2101010","1860","Kentucky","210","Henderson","1010","Henderson",5242955,153169,739644,9294,587,9584,194485,1360486,204069,1564555,5767
"G2101030","1860","Kentucky","210","Henry","1030","Henry",4536880,120507,931147,11638,3302,21602,155323,845426,176925,1022351,3311
"G2101050","1860","Kentucky","210","Hickman","1050","Hickman",1108323,43586,279278,10006,1417,8352,60648,324026,69000,393026,1249
"G2101070","1860","Kentucky","210","Hopkins","1070","Hopkins",2373995,86752,599180,727,0,17938,131932,670542,149870,820412,2009
"G2101090","1860","Kentucky","210","Jackson","1090","Jackson",255526,3601,78883,0,0,7094,21760,66478,28854,95332,7
"G2101110","1860","Kentucky","210","Jefferson","1110","Jefferson",11140950,192773,877085,34218,145605,6086,625203,1089597,631289,1720886,10304
"G2101130","1860","Kentucky","210","Jessamine","1130","Jessamine",5297860,94986,825865,6030,4820,7240,108258,656238,115498,771736,3698
"G2101150","1860","Kentucky","210","Johnson","1150","Johnson",482795,8493,156519,4246,0,15528,39014,164102,54542,218644,27
"G2101170","1860","Kentucky","210","Kenton","1170","Kenton",2613330,78315,363364,12700,62159,9456,60342,462672,69798,532470,567
"G2101210","1860","Kentucky","210","Knox","1210","Knox",881141,22109,273618,402,85,40002,80439,249868,120441,370309,489
"G2101230","1860","Kentucky","210","Larue","1230","Larue",1467474,56587,391165,458,0,14448,68588,359603,83036,442639,900
"G2101250","1860","Kentucky","210","Laurel","1250","Laurel",472778,22604,165520,1038,33,17931,43980,151025,61911,212936,186
"G2101270","1860","Kentucky","210","Lawrence","1270","Lawrence",837015,18041,350059,7143,903,26193,58512,224775,84705,309480,146
"G2101330","1860","Kentucky","210","Letcher","1330","Letcher",281764,14444,119006,3635,1789,20615,31749,101055,52364,153419,108
"G2101350","1860","Kentucky","210","Lewis","1350","Lewis",1428467,48631,326517,10629,1960,8667,64893,318200,73560,391760,230
"G2101370","1860","Kentucky","210","Lincoln","1370","Lincoln",3993899,54509,1076756,5624,10,19677,97338,499296,117015,616311,3430
"G2101390","1860","Kentucky","210","Livingston","1390","Livingston",1283874,50785,321474,3967,77,13467,84592,345456,98059,443515,1222
"G2101410","1860","Kentucky","210","Logan","1410","Logan",5743925,180934,1003228,2147,5305,38221,267296,1081994,305517,1387511,6356
"G2101430","1860","Kentucky","210","Lyon","1430","Lyon",920232,39544,268527,100,0,5998,65284,271662,71282,342944,1094
"G2101450","1860","Kentucky","210","McCracken","1450","Mccracken",1602478,47624,262970,3345,6625,5309,60602,309318,65911,375229,1738
"G2101490","1860","Kentucky","210","McLean","1490","Mclean",1172853,47693,264479,2554,0,19027,60242,347726,79269,426995,888
"G2101510","1860","Kentucky","210","Madison","1510","Madison",7346990,105074,1938858,16128,740,35120,197590,953742,232710,1186452,6034
"G2101530","1860","Kentucky","210","Magoffin","1530","Magoffin",392353,8595,126212,1089,0,8103,24849,106943,32952,139895,71
"G2101550","1860","Kentucky","210","Marion","1550","Marion",3507066,79609,780588,3173,1512,26547,142945,644466,169492,813958,3479
"G2101570","1860","Kentucky","210","Marshall","1570","Marshall",999606,43798,274660,4721,0,16597,68284,295307,84881,380188,351
"G2101610","1860","Kentucky","210","Mason","1610","Mason",6005997,138367,1048656,10635,17103,20208,188465,1149045,208673,1357718,3772
"G2101630","1860","Kentucky","210","Meade","1630","Meade",1937357,69103,404333,11418,1900,13410,87678,463992,101088,565080,1932
"G2101670","1860","Kentucky","210","Mercer","1670","Mercer",4376120,103252,946957,9788,4006,18140,129415,649992,147555,797547,3274
"G2101690","1860","Kentucky","210","Metcalfe","1690","Metcalfe",902722,42179,366025,0,0,10312,57358,279264,67670,346934,781
"G2101710","1860","Kentucky","210","Monroe","1710","Monroe",1082376,43914,352070,1871,0,28226,68610,298405,96836,395241,922
"G2101730","1860","Kentucky","210","Montgomery","1730","Montgomery",3915305,57693,938266,10059,342,14342,100409,653035,114751,767786,2752
"G2101750","1860","Kentucky","210","Morgan","1750","Morgan",1094821,20199,288782,5094,252,26836,68727,284494,95563,380057,170
"G2101770","1860","Kentucky","210","Muhlenberg","1770","Muhlenberg",1848084,69950,520641,3242,0,23346,99149,463792,122495,586287,1584
"G2101790","1860","Kentucky","210","Nelson","1790","Nelson",5047877,124796,1006418,13391,53,23481,168936,715951,192417,908368,5530
"G2101810","1860","Kentucky","210","Nicholas","1810","Nicholas",3377294,75909,942938,8820,227,16639,116310,641176,132949,774125,1614
"G2101830","1860","Kentucky","210","Ohio","1830","Ohio",2128143,97775,649846,2359,194,24780,159967,725106,184747,909853,1292
"G2101850","1860","Kentucky","210","Oldham","1850","Oldham",2706690,81709,495000,12910,1200,7215,71560,447784,78775,526559,2431
"G2101870","1860","Kentucky","210","Owen","1870","Owen",2284137,68469,724509,3125,52,23924,119382,781984,143306,925290,1660
"G2101890","1860","Kentucky","210","Owsley","1890","Owsley",760213,14649,146712,1431,185,15211,53122,181026,68333,249359,112
"G2101910","1860","Kentucky","210","Pendleton","1910","Pendleton",1956278,52987,484265,3922,1700,13832,87665,508220,101497,609717,424
"G2101930","1860","Kentucky","210","Perry","1930","Perry",419538,11431,148622,1662,0,14993,51120,144749,66113,210862,73
"G2101950","1860","Kentucky","210","Pike","1950","Pike",537098,11097,206781,3342,15,26904,56102,206451,83006,289457,97
"G2101970","1860","Kentucky","210","Powell","1970","Powell",273326,8153,99181,1497,0,6979,17463,85379,24442,109821,125
"G2101990","1860","Kentucky","210","Pulaski","1990","Pulaski",2032640,78551,675750,4615,15,49675,150486,534852,200161,735013,1330
"G2102030","1860","Kentucky","210","Rockcastle","2030","Rockcastle",505252,23166,233053,2315,285,18489,48125,179216,66614,245830,357
"G2102050","1860","Kentucky","210","Rowan","2050","Rowan",281576,7559,128286,2087,5205,7646,17837,89384,25483,114867,142
"G2102070","1860","Kentucky","210","Russell","2070","Russell",824714,29185,252644,4930,1,18927,78763,217143,97690,314833,559
"G2102090","1860","Kentucky","210","Scott","2090","Scott",6793203,119886,1339454,3676,1505,16699,151020,823228,167719,990947,5744
"G2102110","1860","Kentucky","210","Shelby","2110","Shelby",9831836,200908,1465012,12730,1170,32506,203684,1261327,236190,1497517,6634
"G2102130","1860","Kentucky","210","Simpson","2130","Simpson",2514577,77383,488032,3963,810,24061,119764,533616,143825,677441,2307
"G2102150","1860","Kentucky","210","Spencer","2150","Spencer",2704902,80030,547291,6445,950,11152,97648,485584,108800,594384,2205
"G2102170","1860","Kentucky","210","Taylor","2170","Taylor",910917,41001,340276,237,12,18348,70500,377713,88848,466561,1597
"G2102190","1860","Kentucky","210","Todd","2190","Todd",4316261,106215,593882,400,0,20435,162816,976928,183251,1160179,4849
"G2102210","1860","Kentucky","210","Trigg","2210","Trigg",1956460,73294,514242,5518,0,15631,133578,665697,149209,814906,3448
"G2102230","1860","Kentucky","210","Trimble","2230","Trimble",1378122,44261,345355,563,1112,6983,59743,319654,66726,386380,831
"G2102250","1860","Kentucky","210","Union","2250","Union",4147800,143700,802680,625,210,25075,246420,889326,271495,1160821,3105
"G2102270","1860","Kentucky","210","Warren","2270","Warren",6268412,142495,1087202,4945,1446,50350,214944,1011836,265294,1277130,5318
"G2102290","1860","Kentucky","210","Washington","2290","Washington",3718324,92484,1009356,4638,558,25980,134691,621726,160671,782397,2822
"G2102310","1860","Kentucky","210","Wayne","2310","Wayne",1929375,49715,460443,2916,14,40014,117213,345827,157227,503054,987
"G2102330","1860","Kentucky","210","Webster","2330","Webster",1232375,53566,309029,648,24,13812,79332,464005,93144,557149,1083
"G2102350","1860","Kentucky","210","Whitley","2350","Whitley",338607,28724,257375,20,0,36478,71882,222102,108360,330462,183
"G2102390","1860","Kentucky","210","Woodford","2390","Woodford",6642240,154875,1058522,2277,3914,16241,114908,765046,131149,896195,5829
"G2200050","1860","Louisiana","220","Ascension","0050","Ascension",6253790,887690,533868,150,0,52073,720,1828838,52793,1881631,7376
"G2200070","1860","Louisiana","220","Assumption","0070","Assumption",7013350,700319,618210,0,0,34203,48301,2075917,82504,2158421,8096
"G2200090","1860","Louisiana","220","Avoyelles","0090","Avoyelles",5175358,238787,556505,0,150,42486,75585,1739223,118071,1857294,7185
"G2200130","1860","Louisiana","220","Bienville","0130","Bienville",,,,,,,,,,,5000
"G2200150","1860","Louisiana","220","Bossier","0150","Bossier",4657057,228991,655008,0,0,0,129128,2292217,129128,2421345,8000
"G2200170","1860","Louisiana","220","Caddo","0170","Caddo",3843015,110476,435401,29975,15134,2840,27445,851618,30285,881903,7338
"G2200190","1860","Louisiana","220","Calcasieu","0190","Calcasieu",236920,41675,197055,75,0,16285,50568,102302,66853,169155,1171
"G2200210","1860","Louisiana","220","Caldwell","0210","Caldwell",1701075,87266,231497,300,25,190,9702,422697,9892,432589,1945
"G2200235","1860","Louisiana","220","Carroll","0235","Carroll",15068712,596883,1127725,24220,1967,16464,96155,4409862,112619,4522481,13908
"G2200250","1860","Louisiana","220","Catahoula","0250","Catahoula",5693255,149160,588305,0,0,0,45784,1320874,45784,1366658,6113
"G2200270","1860","Louisiana","220","Claiborne","0270","Claiborne",2775080,215303,618121,1075,0,9202,198504,1266354,207706,1474060,7848
"G2200290","1860","Louisiana","220","Concordia","0290","Concordia",12335720,837310,920581,300,1300,600,45273,3413906,45873,3459779,12542
"G2200310","1860","Louisiana","220","De Soto","0310","De Soto",2546987,78357,638568,0,0,3190,113898,1066093,117088,1183181,8507
"G2200330","1860","Louisiana","220","East Baton Rouge","0330","East Baton Rouge",2588300,592848,470525,0,900,0,47382,1335848,47382,1383230,8570
"G2200370","1860","Louisiana","220","East Feliciana","0370","East Feliciana",2218878,213965,592073,0,0,0,50410,1447337,50410,1497747,10593
"G2200410","1860","Louisiana","220","Franklin","0410","Franklin",1674572,69682,305856,0,0,0,30013,552283,30013,582296,3402
"G2200470","1860","Louisiana","220","Iberville","0470","Iberville",12661190,886719,1111205,0,1150,200,48315,1285260,48515,1333775,10680
"G2200490","1860","Louisiana","220","Jackson","0490","Jackson",1343760,90799,448232,0,0,19158,107080,727997,126238,854235,4098
"G2200510","1860","Louisiana","220","Jefferson","0510","Jefferson",2682080,55060,211275,0,140600,0,0,1158022,0,1158022,5120
"G2200550","1860","Louisiana","220","Lafayette","0550","Lafayette",1224630,124635,350835,120,950,20667,81599,949765,102266,1052031,4463
"G2200570","1860","Louisiana","220","Lafourche","0570","Lafourche",4104100,568292,422822,0,0,20,13553,1682767,13573,1696340,6395
"G2200630","1860","Louisiana","220","Livingston","0630","Livingston",317038,28250,172210,0,0,0,32145,124303,32145,156448,1311
"G2200650","1860","Louisiana","220","Madison","0650","Madison",11640660,364920,756953,0,0,0,62204,2623774,62204,2685978,12477
"G2200670","1860","Louisiana","220","Morehouse","0670","Morehouse",5505285,143472,470232,0,0,12,70752,1226666,70764,1297430,6569
"G2200690","1860","Louisiana","220","Natchitoches","0690","Natchitoches",5059293,99815,616845,0,0,0,19675,2019498,19675,2039173,9434
"G2200710","1860","Louisiana","220","Orleans","0710","Orleans",1301000,77050,125965,5650,205900,500,2800,461766,3300,465066,14484
"G2200730","1860","Louisiana","220","Ouachita","0730","Ouachita",2323633,97489,229958,1075,0,0,16891,504967,16891,521858,2840
"G2200750","1860","Louisiana","220","Plaquemines","0750","Plaquemines",2791700,161000,572640,33055,0,0,0,1691279,0,1691279,5385
"G2200770","1860","Louisiana","220","Pointe Coupee","0770","Pointe Coupee",8815520,2113835,920730,3556,8300,0,30951,3046898,30951,3077849,12903
"G2200790","1860","Louisiana","220","Rapides","0790","Rapides",9340612,1092340,1405040,0,7830,3336,110785,4054897,114121,4169018,15358
"G2200850","1860","Louisiana","220","Sabine","0850","Sabine",414746,43327,248295,0,0,3354,48025,352198,51379,403577,1713
"G2200870","1860","Louisiana","220","St Bernard","0870","St Bernard",,,,,,,,,,,2240
"G2200890","1860","Louisiana","220","St Charles","0890","St Charles",3261900,579795,332019,5770,4975,225600,9157,881548,234757,1116305,4182
"G2200910","1860","Louisiana","220","St Helena","0910","St Helena",1460107,80657,306528,1308,685,2941,45072,423980,48013,471993,3711
"G2200930","1860","Louisiana","220","St James","0930","St James",3557050,1361200,459793,0,0,0,0,1663308,0,1663308,8090
"G2200950","1860","Louisiana","220","St John The Baptist","0950","St John The Baptist",2592800,408250,309660,0,12000,0,0,667924,0,667924,4594
"G2200970","1860","Louisiana","220","St Landry","0970","St Landry",5026118,314110,814278,0,0,17916,109055,1697346,126971,1824317,11436
"G2200990","1860","Louisiana","220","St Martin","0990","St Martin",4850021,256027,537210,30,280,10,44955,1258647,44965,1303612,7358
"G2201010","1860","Louisiana","220","St Mary","1010","St Mary",9737100,1266695,1322850,0,0,0,0,2823449,0,2823449,13057
"G2201030","1860","Louisiana","220","St Tammany","1030","St Tammany",168261,4323,108755,0,3158,500,15321,53655,15821,69476,1841
"G2201070","1860","Louisiana","220","Tensas","1070","Tensas",15452764,728074,913835,7530,300,225,61191,7155280,61416,7216696,14592
"G2201090","1860","Louisiana","220","Terrebonne","1090","Terrebonne",7166390,946733,587124,0,1800,40,11622,1957616,11662,1969278,6785
"G2201110","1860","Louisiana","220","Union","1110","Union",1166836,115370,458307,0,0,12720,49747,726594,62467,789061,3745
"G2201130","1860","Louisiana","220","Vermilion","1130","Vermillion",412365,55025,519700,0,0,6805,20000,872424,26805,899229,1316
"G2201170","1860","Louisiana","220","Washington","1170","Washington",247720,37602,217897,0,0,6924,40307,214035,47231,261266,1690
"G2201210","1860","Louisiana","220","West Baton Rouge","1210","West Baton Rouge",3650210,1106250,385125,150,1950,0,9250,1214376,9250,1223626,5340
"G2201250","1860","Louisiana","220","West Feliciana","1250","West Feliciana",2244516,345725,534841,0,3815,0,34884,1766297,34884,1801181,9571
"G2201270","1860","Louisiana","220","Winn","1270","Winn",488190,46674,186483,0,0,3639,31126,220369,34765,255134,1354
"G2300010","1860","Maine","230","Androscoggin","0010","Androscoggin",4990907,180428,822209,30444,5703,12684,168532,1104353,181216,1285569,
"G2300030","1860","Maine","230","Aroostook","0030","Aroostook",2217136,178182,765138,1684,830,45879,171176,1123161,217055,1340216,
"G2300050","1860","Maine","230","Cumberland","0050","Cumberland",9470564,280129,1176445,33574,36600,26926,215007,1637115,241933,1879048,
"G2300070","1860","Maine","230","Franklin","0070","Franklin",3643748,172525,977136,46683,3023,26639,123801,1337894,150440,1488334,
"G2300090","1860","Maine","230","Hancock","0090","Hancock",3022796,98010,644310,7045,25193,64346,120388,710439,184734,895173,
"G2300110","1860","Maine","230","Kennebec","0110","Kennebec",8858356,375864,1637826,77054,17201,26491,286111,2196776,312602,2509378,
"G2300130","1860","Maine","230","Knox","0130","Knox",2707250,133122,440117,13288,12128,29916,102592,562944,132508,695452,
"G2300150","1860","Maine","230","Lincoln","0150","Lincoln",3960878,138030,603855,15795,14313,22796,114154,825025,136950,961975,
"G2300170","1860","Maine","230","Oxford","0170","Oxford",5615754,273548,1458172,84465,19530,44907,218798,2001432,263705,2265137,
"G2300190","1860","Maine","230","Penobscot","0190","Penobscot",6711673,371888,1605051,33067,10688,44667,361849,2166785,406516,2573301,
"G2300210","1860","Maine","230","Piscataquis","0210","Piscataquis",1764327,100896,580041,10735,0,16037,88312,938576,104349,1042925,
"G2300230","1860","Maine","230","Sagadahoc","0230","Sagadahoc",2487209,75134,328162,7070,6516,12694,58274,465405,70968,536373,
"G2300250","1860","Maine","230","Somerset","0250","Somerset",5729553,323945,1524684,42880,2780,33346,204561,1993063,237907,2230970,
"G2300270","1860","Maine","230","Waldo","0270","Waldo",4516496,240002,973517,40350,15110,26969,169532,1427824,196501,1624325,
"G2300290","1860","Maine","230","Washington","0290","Washington",2234257,94590,520558,2676,7634,31327,107888,605065,139215,744280,
"G2300310","1860","Maine","230","York","0310","York",10757624,262034,1380312,54957,16757,25162,269204,1634745,294366,1929111,
"G2400010","1860","Maryland","240","Allegany","0010","Allegany",3155563,100395,513281,14455,6245,9178,88908,742782,98086,840868,666
"G2400030","1860","Maryland","240","Anne Arundel","0030","Anne Arundel",7512331,189834,616267,14135,218680,0,108863,1328648,108863,1437511,7332
"G2400050","1860","Maryland","240","Baltimore","0050","Baltimore",22491196,455857,1303873,25279,236365,190,179136,2235608,179326,2414934,5400
"G2400090","1860","Maryland","240","Calvert","0090","Calvert",3407902,64354,380338,177,0,1717,62216,646633,63933,710566,4609
"G2400110","1860","Maryland","240","Caroline","0110","Caroline",1222685,30315,155113,1418,115,10,36206,311835,36216,348051,739
"G2400130","1860","Maryland","240","Carroll","0130","Carroll",7567638,271805,784346,0,0,1066,178897,1593480,179963,1773443,783
"G2400150","1860","Maryland","240","Cecil","0150","Cecil",8168950,287988,877563,26405,1130,258,142497,1691231,142755,1833986,950
"G2400170","1860","Maryland","240","Charles","0170","Charles",3236015,89009,439283,3045,1300,10108,84938,667731,95046,762777,9653
"G2400190","1860","Maryland","240","Dorchester","0190","Dorchester",3669040,92423,458091,4872,24,1846,118361,882063,120207,1002270,4123
"G2400210","1860","Maryland","240","Frederick","0210","Frederick",14127926,441814,1534048,11064,585,1478,281467,3008243,282945,3291188,3243
"G2400250","1860","Maryland","240","Harford","0250","Harford",7433740,268546,878736,8201,1333,1174,169133,1458350,170307,1628657,1800
"G2400270","1860","Maryland","240","Howard","0270","Howard",4514648,139148,455964,5507,5693,707,91205,800153,91912,892065,2862
"G2400290","1860","Maryland","240","Kent","0290","Kent",6877390,132655,699502,85227,120,112,107557,1456830,107669,1564499,2509
"G2400310","1860","Maryland","240","Montgomery","0310","Montgomery",5920318,314708,852767,3227,13655,12455,194186,1455430,206641,1662071,5421
"G2400330","1860","Maryland","240","Prince Georges","0330","Prince Georges",10421108,211971,875317,5370,30483,0,90603,1668268,90603,1758871,12479
"G2400350","1860","Maryland","240","Queen Anne's","0350","Queen Anne's",5236080,146075,627447,1867,1680,0,130775,1190046,130775,1320821,4174
"G2400370","1860","Maryland","240","St Mary's","0370","St Mary's",4395135,109908,546046,8306,75,5989,133846,1019552,139835,1159387,6549
"G2400390","1860","Maryland","240","Somerset","0390","Somerset",4626241,91795,466892,6424,6416,7084,154082,779020,161166,940186,5089
"G2400410","1860","Maryland","240","Talbot","0410","Talbot",5774848,126950,601861,6199,3755,153,122946,1052104,123099,1175203,3725
"G2400430","1860","Maryland","240","Washington","0430","Washington",11954804,354938,1056125,20656,2507,140,207034,2252637,207174,2459811,1435
"G2400470","1860","Maryland","240","Worcester","0470","Worcester",4260120,90041,544993,362,60,13338,138654,917320,151992,1069312,3648
"G2500010","1860","Massachusetts","250","Barnstable","0010","Barnstable",2129156,85095,219777,2697,11851,0,57740,233234,57740,290975,
"G2500030","1860","Massachusetts","250","Berkshire","0030","Berkshire",9913858,330891,1631885,27174,10567,11094,304582,2038850,315676,2354526,
"G2500050","1860","Massachusetts","250","Bristol","0050","Bristol",6883141,222884,617927,17812,39145,35065,210718,638850,245783,884633,
"G2500070","1860","Massachusetts","250","Dukes","0070","Dukes",609790,15118,74143,359,15,1445,17100,55543,18545,74088,
"G2500090","1860","Massachusetts","250","Essex","0090","Essex",10330506,341384,856145,121980,173648,65,218504,1271931,218569,1490500,
"G2500110","1860","Massachusetts","250","Franklin","0110","Franklin",7569223,234427,1173401,47056,1177,13713,221856,1386876,235569,1622445,
"G2500130","1860","Massachusetts","250","Hampden","0130","Hampden",7402883,266101,995160,32520,31252,3326,197747,1273967,201073,1475040,
"G2500150","1860","Massachusetts","250","Hampshire","0150","Hampshire",7730161,296214,1086172,44159,4125,32514,167469,1469660,199983,1669643,
"G2500170","1860","Massachusetts","250","Middlesex","0170","Middlesex",24396128,895059,1834446,333055,798261,40200,416308,2973842,456508,3430350,
"G2500190","1860","Massachusetts","250","Nantucket","0190","Nantucket",166548,12015,43358,30,5283,0,5674,46928,5674,52602,
"G2500210","1860","Massachusetts","250","Norfolk","0210","Norfolk",15539042,276108,784767,83335,216501,33165,169221,940888,202386,1143275,
"G2500230","1860","Massachusetts","250","Plymouth","0230","Plymouth",7620646,185078,632816,13965,33944,4988,262645,619785,267633,887418,
"G2500250","1860","Massachusetts","250","Suffolk","0250","Suffolk",754600,16710,31125,10925,27935,0,6118,79313,6118,85431,
"G2500270","1860","Massachusetts","250","Worcester","0270","Worcester",22210268,717914,2756622,190452,43919,70311,659363,3277770,729674,4007444,
"G2600010","1860","Michigan","260","Alcona","0010","Alcona",,,,,,,,,,,
"G2600050","1860","Michigan","260","Allegan","0050","Allegan",3220560,143070,497967,12288,4844,3322,89925,579828,93247,673075,
"G2600070","1860","Michigan","260","Alpena","0070","Alpena",,,,,,,,,,,
"G2600090","1860","Michigan","260","Antrim","0090","Antrim",,,,,,,,,,,
"G2600150","1860","Michigan","260","Barry","0150","Barry",2825235,113888,461854,10488,5530,2568,86354,654977,88922,743899,
"G2600170","1860","Michigan","260","Bay","0170","Bay",134110,8110,21993,0,200,0,11294,37878,11294,49172,
"G2600210","1860","Michigan","260","Berrien","0210","Berrien",4730978,135847,566099,75737,4615,3845,122859,778913,126704,905617,
"G2600230","1860","Michigan","260","Branch","0230","Branch",5118105,134353,797086,33491,950,1025,109404,974115,110429,1084544,
"G2600250","1860","Michigan","260","Calhoun","0250","Calhoun",7529957,334178,1232006,61376,18495,6738,195079,1813790,201817,2015607,
"G2600270","1860","Michigan","260","Cass","0270","Cass",5351411,154049,665143,67214,537,2425,179340,1030264,181765,1212029,
"G2600310","1860","Michigan","260","Cheboygan","0310","Cheboygan",12787,538,5106,0,0,0,1104,5728,1104,6832,
"G2600330","1860","Michigan","260","Chippewa","0330","Chippewa",70530,4895,9294,0,0,0,0,14671,0,14671,
"G2600370","1860","Michigan","260","Clinton","0370","Clinton",3580940,128553,505657,7042,829,1982,97254,619012,99236,718248,
"G2600410","1860","Michigan","260","Delta","0410","Delta",12170,905,5300,0,0,0,1325,7063,1325,8388,
"G2600450","1860","Michigan","260","Eaton","0450","Eaton",3385669,125204,547088,14583,327,9388,73641,559071,83029,642100,
"G2600470","1860","Michigan","260","Emmet","0470","Emmet",21290,953,6491,125,150,50,1640,9963,1690,11653,
"G2600490","1860","Michigan","260","Genesee","0490","Genesee",4569410,170751,686872,13257,11040,2227,117584,741156,119811,860967,
"G2600510","1860","Michigan","260","Gladwin","0510","Gladwin",,,,,,,,,,,
"G2600550","1860","Michigan","260","Grand Traverse","0550","Grand Traverse",67230,2260,22107,0,40,0,4890,14945,4890,19835,
"G2600570","1860","Michigan","260","Gratiot","0570","Gratiot",324237,11312,50299,0,0,0,6262,58361,6262,64623,
"G2600590","1860","Michigan","260","Hillsdale","0590","Hillsdale",7282172,274677,1162582,63523,831,9246,190543,1460374,199789,1660163,
"G2600610","1860","Michigan","260","Houghton","0610","Houghton",106040,2170,9990,0,0,0,0,10886,0,10886,
"G2600630","1860","Michigan","260","Huron","0630","Huron",124200,400,27916,0,100,0,1905,24216,1905,26121,
"G2600650","1860","Michigan","260","Ingham","0650","Ingham",3566344,117707,521342,18820,5395,15603,83105,655276,98708,753984,
"G2600670","1860","Michigan","260","Ionia","0670","Ionia",3891900,163595,600419,12016,200,6590,81861,687217,88451,775668,
"G2600690","1860","Michigan","260","Iosco","0690","Iosco",,,,,,,,,,,
"G2600730","1860","Michigan","260","Isabella","0730","Isabella",98100,5726,11451,0,1329,0,2389,10437,2389,12826,
"G2600750","1860","Michigan","260","Jackson","0750","Jackson",8492460,251938,1277645,85274,1254,6551,163523,1840759,170074,2010833,
"G2600770","1860","Michigan","260","Kalamazoo","0770","Kalamazoo",8137368,265160,996858,47381,7320,3253,146019,1368425,149272,1517697,
"G2600810","1860","Michigan","260","Kent","0810","Kent",6552452,200544,755719,24256,14105,13507,122355,1014742,135862,1150604,
"G2600870","1860","Michigan","260","Lapeer","0870","Lapeer",3286909,168860,563103,10502,249,6915,103029,621583,109944,731527,
"G2600890","1860","Michigan","260","Leelanau","0890","Leelanau",65011,3205,7140,0,0,0,2168,13061,2168,15229,
"G2600910","1860","Michigan","260","Lenawee","0910","Lenawee",9350796,329394,1517422,81881,4283,2300,305576,1897294,307876,2205170,
"G2600930","1860","Michigan","260","Livingston","0930","Livingston",4604860,161463,775233,19072,526,3845,111065,981723,114910,1096633,
"G2600990","1860","Michigan","260","Macomb","0990","Macomb",6367273,296594,906351,25721,8916,6769,159021,870787,165790,1036577,
"G2601010","1860","Michigan","260","Manistee","1010","Manistee",,,,,,,,,,,
"G2601015","1860","Michigan","260","Manitou","1015","Manitou",6000,1180,2411,0,0,0,180,1599,180,1779,
"G2601030","1860","Michigan","260","Marquette","1030","Marquette",64085,1625,5951,0,1069,0,1194,10813,1194,12007,
"G2601050","1860","Michigan","260","Mason","1050","Mason",8050,1825,1300,125,0,0,410,1833,410,2243,
"G2601070","1860","Michigan","260","Mecosta","1070","Mecosta",29400,710,5252,0,0,0,272,6439,272,6711,
"G2601095","1860","Michigan","260","Michilimackinac","1095","Michilimackinac",16350,155,3170,30,0,0,286,3553,286,3839,
"G2601110","1860","Michigan","260","Midland","1110","Midland",95700,3569,6005,0,2350,0,2303,14566,2303,16869,
"G2601150","1860","Michigan","260","Monroe","1150","Monroe",4026965,158638,722867,34134,1417,1887,125049,983412,126936,1110348,
"G2601170","1860","Michigan","260","Montcalm","1170","Montcalm",517230,22053,72770,878,4,836,11907,89456,12743,102199,
"G2601210","1860","Michigan","260","Muskegon","1210","Muskegon",240380,7806,29551,10,32,80,7362,31877,7442,39319,
"G2601230","1860","Michigan","260","Newaygo","1230","Newaygo",129000,6293,19103,0,0,0,3290,25057,3290,28347,
"G2601250","1860","Michigan","260","Oakland","1250","Oakland",13624758,473464,2036309,97560,3623,7359,342608,2418773,349967,2768740,
"G2601270","1860","Michigan","260","Oceana","1270","Oceana",227770,3602,23810,1717,25,0,6213,23391,6213,29604,
"G2601310","1860","Michigan","260","Ontonagon","1310","Ontonagon",163950,7530,19971,0,350,0,17710,21189,17710,38899,
"G2601330","1860","Michigan","260","Osceola","1330","Osceola",5200,0,1370,0,0,0,225,867,225,1092,
"G2601390","1860","Michigan","260","Ottawa","1390","Ottawa",1724415,57992,241337,4707,12350,2147,53001,323051,55148,378199,
"G2601410","1860","Michigan","260","Presque Isle","1410","Presque Isle",,,,,,,,,,,
"G2601450","1860","Michigan","260","Saginaw","1450","Saginaw",666827,55015,124572,0,1000,400,26055,175769,26455,202224,
"G2601470","1860","Michigan","260","St Clair","1470","St Clair",1659142,62540,213841,1325,290,1248,44607,307144,45855,352999,
"G2601490","1860","Michigan","260","St Joseph","1490","St Joseph",6652824,249986,902544,36251,915,6273,155803,1421347,162076,1583423,
"G2601510","1860","Michigan","260","Sanilac","1510","Sanilac",422790,15569,54365,35,435,0,11795,87172,11795,98967,
"G2601530","1860","Michigan","260","Schoolcraft","1530","Schoolcraft",42000,130,400,0,40,0,30,541,30,571,
"G2601550","1860","Michigan","260","Shiawassee","1550","Shiawassee",2085469,88493,364839,9607,1885,3643,49449,403682,53092,456774,
"G2601570","1860","Michigan","260","Tuscola","1570","Tuscola",1015316,19881,132341,6,0,300,18504,117789,18804,136593,
"G2601590","1860","Michigan","260","Van Buren","1590","Van Buren",3052805,107041,391856,24201,10105,980,84009,574673,84989,659662,
"G2601610","1860","Michigan","260","Washtenaw","1610","Washtenaw",12234670,446438,2017346,139480,6754,5316,351677,2483185,356993,2840178,
"G2601630","1860","Michigan","260","Wayne","1630","Wayne",9244898,318008,1107957,87961,18174,4138,208908,1302777,213046,1515823,
"G2700010","1860","Minnesota","270","Aitkin","0010","Aitkin",,,,,,,,,,,
"G2700030","1860","Minnesota","270","Anoka","0030","Anoka",182885,9396,44062,0,266,0,6262,85215,6262,91477,
"G2700050","1860","Minnesota","270","Becker","0050","Becker",,,,,,,,,,,
"G2700090","1860","Minnesota","270","Benton","0090","Benton",68850,2158,9295,100,18,0,2544,20139,2544,22683,
"G2700130","1860","Minnesota","270","Blue Earth","0130","Blue Earth",309271,28684,65316,0,4250,0,13899,421590,13899,435489,
"G2700135","1860","Minnesota","270","Breckinridge","0135","Breckinridge",,,,,,,,,,,
"G2700150","1860","Minnesota","270","Brown","0150","Brown",215210,16197,46522,30,3862,235,7047,49075,7282,56357,
"G2700155","1860","Minnesota","270","Buchanan","0155","Buchanan",,,,,,,,,,,
"G2700170","1860","Minnesota","270","Carlton","0170","Carlton",3800,255,800,0,0,0,330,781,330,1111,
"G2700190","1860","Minnesota","270","Carver","0190","Carver",454310,24554,110912,0,0,0,29122,236933,29122,266055,
"G2700210","1860","Minnesota","270","Cass","0210","Cass",,,,,,,,,,,
"G2700250","1860","Minnesota","270","Chisago","0250","Chisago",124019,8445,27153,0,0,75,7903,60555,7978,68533,
"G2700330","1860","Minnesota","270","Cottonwood","0330","Cottonwood",2600,150,340,0,0,0,56,642,56,698,
"G2700350","1860","Minnesota","270","Crow Wing","0350","Crow Wing",,,,,,,,,,,
"G2700370","1860","Minnesota","270","Dakota","0370","Dakota",1228387,68412,202177,0,3197,60,38395,498454,38455,536909,
"G2700390","1860","Minnesota","270","Dodge","0390","Dodge",441070,32402,101452,0,0,97,17206,216079,17303,233382,
"G2700410","1860","Minnesota","270","Douglas","0410","Douglas",13000,2115,5060,0,0,0,630,7787,630,8417,
"G2700430","1860","Minnesota","270","Faribault","0430","Faribault",112400,9111,29164,0,195,125,8282,70134,8407,78541,
"G2700450","1860","Minnesota","270","Fillmore","0450","Fillmore",1844797,50431,429091,0,0,25,56649,979938,56674,1036612,
"G2700470","1860","Minnesota","270","Freeborn","0470","Freeborn",293646,17399,69607,0,0,0,8582,173625,8582,182207,
"G2700490","1860","Minnesota","270","Goodhue","0490","Goodhue",785837,55722,172918,0,3590,3670,25310,395320,28980,424300,
"G2700530","1860","Minnesota","270","Hennepin","0530","Hennepin",1367862,90599,235715,250,33070,15,153620,570405,153635,724040,
"G2700550","1860","Minnesota","270","Houston","0550","Houston",990598,37358,141801,0,800,1566,34305,307910,35871,343781,
"G2700590","1860","Minnesota","270","Isanti","0590","Isanti",23430,1377,5460,0,216,0,556,11410,556,11966,
"G2700610","1860","Minnesota","270","Itasca","0610","Itasca",,,,,,,,,,,
"G2700630","1860","Minnesota","270","Jackson","0630","Jackson",2350,170,725,0,0,0,16,1031,16,1047,
"G2700650","1860","Minnesota","270","Kanabec","0650","Kanabec",4500,340,2550,0,100,0,550,2688,550,3238,
"G2700670","1860","Minnesota","270","Kandiyohi","0670","Kandiyohi",4400,332,1179,0,0,0,73,2826,73,2899,
"G2700750","1860","Minnesota","270","Lake","0750","Lake",,,,,,,,,,,
"G2700790","1860","Minnesota","270","Le Sueur","0790","Le Sueur",575465,30927,130712,0,0,100,42499,294158,42599,336757,
"G2700850","1860","Minnesota","270","McLeod","0850","Mcleod",99815,4127,25217,0,0,0,3372,52255,3372,55627,
"G2700877","1860","Minnesota","270","Manomin","0877","Manomin",62060,1735,5210,0,0,0,1250,17498,1250,18748,
"G2700910","1860","Minnesota","270","Martin","0910","Martin",5800,467,1410,0,0,0,296,3455,296,3751,
"G2700930","1860","Minnesota","270","Meeker","0930","Meeker",75710,5047,22664,0,140,0,2805,45590,2805,48395,
"G2700950","1860","Minnesota","270","Mille Lacs","0950","Mille Lacs",4090,290,1380,0,50,0,130,1952,130,2082,
"G2700955","1860","Minnesota","270","Monongalia","0955","Monongalia",7500,660,3500,0,0,0,305,6974,305,7279,
"G2700970","1860","Minnesota","270","Morrison","0970","Morrison",56800,3855,12680,0,120,0,2194,17782,2194,19976,
"G2700990","1860","Minnesota","270","Mower","0990","Mower",234630,13927,50505,0,0,106,7522,106451,7628,114079,
"G2701010","1860","Minnesota","270","Murray","1010","Murray",1500,260,325,0,0,0,113,1372,113,1485,
"G2701030","1860","Minnesota","270","Nicollet","1030","Nicollet",502885,30719,96433,0,9175,197,11146,213142,11343,224485,
"G2701050","1860","Minnesota","270","Nobles","1050","Nobles",,,,,,,,,,,
"G2701090","1860","Minnesota","270","Olmsted","1090","Olmsted",1453690,45551,257306,0,50,0,36603,620520,36603,657123,
"G2701110","1860","Minnesota","270","Otter Tail","1110","Otter Tail",17550,1575,3630,0,0,0,0,9986,0,9986,
"G2701115","1860","Minnesota","270","Pembina","1115","Pembina",,,,,,,,,,,
"G2701135","1860","Minnesota","270","Pierce","1135","Pierce",,,,,,,,,,,
"G2701150","1860","Minnesota","270","Pine","1150","Pine",4500,675,1155,0,0,0,122,3743,122,3865,
"G2701175","1860","Minnesota","270","Pipestone (old)","1175","Pipestone (old)",,,,,,,,,,,
"G2701190","1860","Minnesota","270","Polk","1190","Polk",16000,2425,5450,0,0,0,700,6636,700,7336,
"G2701230","1860","Minnesota","270","Ramsey","1230","Ramsey",509710,21879,61915,0,23425,0,8342,116958,8342,125300,
"G2701290","1860","Minnesota","270","Renville","1290","Renville",24660,2962,10698,0,0,0,60,9269,60,9329,
"G2701310","1860","Minnesota","270","Rice","1310","Rice",985955,59971,179817,182,100,0,35066,453238,35066,488304,
"G2701370","1860","Minnesota","270","St Louis","1370","St Louis",21100,1270,2560,0,0,0,425,3455,425,3880,
"G2701390","1860","Minnesota","270","Scott","1390","Scott",694230,37044,124232,0,258,0,25857,234535,25857,260392,
"G2701410","1860","Minnesota","270","Sherburne","1410","Sherburne",126631,8860,26913,0,0,0,4656,48381,4656,53037,
"G2701430","1860","Minnesota","270","Sibley","1430","Sibley",284700,20508,82501,0,20,10,15060,97451,15070,112521,
"G2701450","1860","Minnesota","270","Stearns","1450","Stearns",627000,29900,118243,0,0,0,19282,251936,19282,271218,
"G2701470","1860","Minnesota","270","Steele","1470","Steele",332150,19595,73511,0,0,51,10457,154160,10508,164668,
"G2701530","1860","Minnesota","270","Todd","1530","Todd",55200,3495,10920,60,50,0,525,10514,525,11039,
"G2701535","1860","Minnesota","270","Toombs","1535","Toombs",,,,,,,,,,,
"G2701570","1860","Minnesota","270","Wabasha","1570","Wabasha",1144595,90093,221850,0,305,1091,25666,382041,26757,408798,
"G2701610","1860","Minnesota","270","Waseca","1610","Waseca",160180,11452,40548,0,150,335,8595,94691,8930,103621,
"G2701630","1860","Minnesota","270","Washington","1630","Washington",702615,39112,122388,0,335,152,25430,254825,25582,280407,
"G2701690","1860","Minnesota","270","Winona","1690","Winona",9820188,53744,156902,7,200,0,30401,407230,30401,437631,
"G2701710","1860","Minnesota","270","Wright","1710","Wright",425792,20451,90967,20,10762,81,21328,187040,21409,208449,
"G2800010","1860","Mississippi","280","Adams","0010","Adams",3000800,81595,787100,22210,49211,6980,74180,1786647,81160,1867807,14292
"G2800050","1860","Mississippi","280","Amite","0050","Amite",2169575,137685,645834,13400,350,9586,104859,1195763,114445,1310208,7900
"G2800070","1860","Mississippi","280","Attala","0070","Attala",2435023,98871,791421,100,100,18405,170819,1079232,189224,1268456,5015
"G2800110","1860","Mississippi","280","Bolivar","0110","Bolivar",8759270,284036,753247,0,0,0,35836,1800720,35836,1836556,9078
"G2800130","1860","Mississippi","280","Calhoun","0130","Calhoun",1260177,113891,426258,797,0,23046,125209,595294,148255,743549,1823
"G2800150","1860","Mississippi","280","Carroll","0150","Carroll",8276506,355714,1493654,2555,2752,3949,289218,2841137,293167,3134304,13808
"G2800170","1860","Mississippi","280","Chickasaw","0170","Chickasaw",4509034,150674,998901,4349,360,45996,277844,1781690,323840,2105530,9087
"G2800190","1860","Mississippi","280","Choctaw","0190","Choctaw",2432510,137865,908527,622,0,136848,192526,1038883,329374,1368257,4197
"G2800210","1860","Mississippi","280","Claiborne","0210","Claiborne",4778610,194750,996975,23250,18015,128245,110385,2021722,238630,2260352,12296
"G2800230","1860","Mississippi","280","Clarke","0230","Clarke",2293619,75625,433603,1000,0,2393,74318,647516,76711,724227,5076
"G2800270","1860","Mississippi","280","Coahoma","0270","Coahoma",5100595,129750,426656,1000,0,0,17648,758863,17648,776511,5085
"G2800290","1860","Mississippi","280","Copiah","0290","Copiah",1550639,155470,864540,150,50,1668,136304,1413597,137972,1551569,7965
"G2800310","1860","Mississippi","280","Covington","0310","Covington",428195,59113,282841,2861,0,75190,86975,276331,162165,438496,1563
"G2800330","1860","Mississippi","280","DeSoto","0330","De Soto",6578547,282518,1365928,13049,320,7521,250507,2523503,258028,2781531,13987
"G2800370","1860","Mississippi","280","Franklin","0370","Franklin",1341737,150129,449449,0,0,2358,58477,835667,60835,896502,4752
"G2800410","1860","Mississippi","280","Greene","0410","Greene",879110,11728,154146,815,0,4351,24905,48747,29256,78003,705
"G2800450","1860","Mississippi","280","Hancock","0450","Hancock",,,,,,,,,,,857
"G2800470","1860","Mississippi","280","Harrison","0470","Harrison",683900,25900,130461,4800,865,1694,11183,268471,12877,281348,1015
"G2800490","1860","Mississippi","280","Hinds","0490","Hinds",6240445,311161,1432495,5459,4157,1016,226842,3314496,227858,3542354,22363
"G2800510","1860","Mississippi","280","Holmes","0510","Holmes",6074192,267102,1141658,205,5,9477,205809,2495538,215286,2710824,11975
"G2800550","1860","Mississippi","280","Issaquena","0550","Issaquena",6576505,273620,438408,0,0,0,600,2166027,600,2166627,7244
"G2800570","1860","Mississippi","280","Itawamba","0570","Itawamba",2021943,142158,860164,2156,1938,86699,197263,1024153,283962,1308115,3528
"G2800590","1860","Mississippi","280","Jackson","0590","Jackson",38006,5347,78547,8389,0,6355,10146,24550,16501,41051,1087
"G2800610","1860","Mississippi","280","Jasper","0610","Jasper",2157167,88824,610147,133,0,20820,129214,758139,150034,908173,4549
"G2800630","1860","Mississippi","280","Jefferson","0630","Jefferson",3232595,220056,944251,7280,12345,40782,149704,1889953,190486,2080439,12396
"G2800670","1860","Mississippi","280","Jones","0670","Jones",351438,18895,190303,2127,0,19782,34837,96909,54619,151528,407
"G2800690","1860","Mississippi","280","Kemper","0690","Kemper",2533819,108841,665306,1310,0,17684,146413,1079505,164097,1243602,5741
"G2800710","1860","Mississippi","280","Lafayette","0710","Lafayette",3180690,156510,768630,300,400,27490,229461,1368681,256951,1625632,7129
"G2800750","1860","Mississippi","280","Lauderdale","0750","Lauderdale",2032489,139059,657607,11257,25,19063,134880,963819,153943,1117762,5088
"G2800770","1860","Mississippi","280","Lawrence","0770","Lawrence",1286135,80761,478497,0,0,10367,94616,496827,104983,601810,3696
"G2800790","1860","Mississippi","280","Leake","0790","Leake",1413378,72342,440035,4590,0,14278,104103,728945,118381,847326,3056
"G2800870","1860","Mississippi","280","Lowndes","0870","Lowndes",7726605,188010,1102729,0,0,9596,275198,3122159,284794,3406953,16730
"G2800890","1860","Mississippi","280","Madison","0890","Madison",8181595,434675,1373590,2029,1120,18628,232335,3171273,250963,3422236,18118
"G2800910","1860","Mississippi","280","Marion","0910","Marion",386083,27807,0,0,0,10773,44970,205858,55743,261601,2185
"G2800930","1860","Mississippi","280","Marshall","0930","Marshall",7076960,415410,1508821,9995,2515,49656,350295,3163194,399951,3563145,17439
"G2800950","1860","Mississippi","280","Monroe","0950","Monroe",6446406,179597,1255623,2464,3211,22944,284321,2942705,307265,3249970,12729
"G2800990","1860","Mississippi","280","Neshoba","0990","Neshoba",960192,69164,485021,151,0,19985,80224,459263,100209,559472,2212
"G2801010","1860","Mississippi","280","Newton","1010","Newton",1179733,64273,438160,0,0,11299,74198,600966,85497,686463,3379
"G2801030","1860","Mississippi","280","Noxubee","1030","Noxubee",8353247,244804,1486462,90,265,9513,327037,3123138,336550,3459688,15496
"G2801050","1860","Mississippi","280","Oktibbeha","1050","Oktibbeha",3352455,137152,820555,18875,80,28896,181220,1385844,210116,1595960,7631
"G2801070","1860","Mississippi","280","Panola","1070","Panola",3682361,198410,889004,5630,5774,6813,186991,1538299,193804,1732103,8557
"G2801110","1860","Mississippi","280","Perry","1110","Perry",209598,11955,199732,4903,0,7186,36299,86751,43485,130236,738
"G2801130","1860","Mississippi","280","Pike","1130","Pike",1544998,127610,619276,10236,5576,17644,116462,678324,134106,812430,4935
"G2801150","1860","Mississippi","280","Pontotoc","1150","Pontotoc",4264377,233148,1360706,6392,271,57320,277800,1788275,335120,2123395,7596
"G2801210","1860","Mississippi","280","Rankin","1210","Rankin",3346169,144230,861250,10140,0,11457,130426,1188013,141883,1329896,7103
"G2801230","1860","Mississippi","280","Scott","1230","Scott",1528199,68134,362799,121,1665,14733,83472,544628,98205,642833,2959
"G2801270","1860","Mississippi","280","Simpson","1270","Simpson",879970,50288,409467,0,0,13275,75470,356220,88745,444965,2324
"G2801290","1860","Mississippi","280","Smith","1290","Smith",1101771,76638,351943,0,0,31263,71383,430145,102646,532791,2195
"G2801330","1860","Mississippi","280","Sunflower","1330","Sunflower",,,,,,,,,,,3917
"G2801350","1860","Mississippi","280","Tallahatchie","1350","Tallahatchie",3337592,158926,546938,46,61,2308,99379,997683,101687,1099370,5054
"G2801390","1860","Mississippi","280","Tippah","1390","Tippah",3349432,228606,1212610,6416,282,144269,259561,1570464,403830,1974294,6331
"G2801410","1860","Mississippi","280","Tishomingo","1410","Tishomingo",2110705,179777,1017938,3360,1253,83990,230527,1109331,314517,1423848,4981
"G2801430","1860","Mississippi","280","Tunica","1430","Tunica",4217575,106793,308625,0,0,0,45098,722186,45098,767284,3483
"G2801490","1860","Mississippi","280","Warren","1490","Warren",5141820,96217,794788,31966,8095,51798,114155,1881986,165953,2047939,13763
"G2801510","1860","Mississippi","280","Washington","1510","Washington",,,,,,,,,,,14467
"G2801530","1860","Mississippi","280","Wayne","1530","Wayne",347840,32301,164464,3676,0,1285,25431,195595,26716,222311,1947
"G2801570","1860","Mississippi","280","Wilkinson","1570","Wilkinson",3389407,254113,888793,614,0,428,75928,2207740,76356,2284096,13132
"G2801590","1860","Mississippi","280","Winston","1590","Winston",1505740,114925,469290,650,0,14820,119105,708997,133925,842922,4223
"G2801610","1860","Mississippi","280","Yalobusha","1610","Yalobusha",3235661,131408,821319,0,0,220,141075,1536083,141295,1677378,9531
"G2801630","1860","Mississippi","280","Yazoo","1630","Yazoo",10287228,522151,1526200,2800,3120,0,165512,3653579,165512,3819091,16716
"G2900010","1860","Missouri","290","Adair","0010","Adair",755715,62139,321564,1244,431,20554,58161,367082,78715,445797,86
"G2900030","1860","Missouri","290","Andrew","0030","Andrew",3000467,105647,593172,9560,850,20007,115333,718022,135340,853362,880
"G2900050","1860","Missouri","290","Atchison","0050","Atchison",1318545,58678,312360,450,6,7017,55945,424244,62962,487206,59
"G2900070","1860","Missouri","290","Audrain","0070","Audrain",3557273,96021,738228,3096,9507,20522,93353,472308,113875,586183,1166
"G2900090","1860","Missouri","290","Barry","0090","Barry",624994,54177,342666,990,150,20985,65759,329890,86744,416634,247
"G2900110","1860","Missouri","290","Barton","0110","Barton",398895,12915,75980,74,101,1836,14549,56938,16385,73323,21
"G2900130","1860","Missouri","290","Bates","0130","Bates",1074464,49537,396377,2074,8789,10036,63748,299458,73784,373242,442
"G2900150","1860","Missouri","290","Benton","0150","Benton",1342291,89625,526558,692,375,10886,69302,335070,80188,415258,599
"G2900170","1860","Missouri","290","Bollinger","0170","Bollinger",694655,50504,264170,6456,50,15850,62395,240020,78245,318265,245
"G2900190","1860","Missouri","290","Boone","0190","Boone",4634820,186246,1621297,25703,1240,33817,212965,1119725,246782,1366507,5034
"G2900210","1860","Missouri","290","Buchanan","0210","Buchanan",6523511,135519,837241,30657,5625,20346,208836,966489,229182,1195671,2011
"G2900230","1860","Missouri","290","Butler","0230","Butler",189001,15554,135224,266,0,4631,20657,52592,25288,77880,52
"G2900250","1860","Missouri","290","Caldwell","0250","Caldwell",1282636,66008,465706,2936,907,17493,57970,303181,75463,378644,222
"G2900270","1860","Missouri","290","Callaway","0270","Callaway",4818339,170814,1306752,28951,6206,46876,192832,1036531,239708,1276239,4523
"G2900290","1860","Missouri","290","Camden","0290","Camden",390845,23096,195530,998,373,8125,29254,134608,37379,171987,206
"G2900310","1860","Missouri","290","Cape Girardeau","0310","Cape Girardeau",2709272,140633,606711,25451,922,29619,136231,582390,165850,748240,1533
"G2900330","1860","Missouri","290","Carroll","0330","Carroll",2467993,111961,521059,6887,9214,16690,116186,566484,132876,699360,1068
"G2900350","1860","Missouri","290","Carter","0350","Carter",105245,7068,53894,465,0,2615,8064,43110,10679,53789,20
"G2900370","1860","Missouri","290","Cass","0370","Cass",2690460,115028,673391,9984,2280,25594,147174,653255,172768,826023,1010
"G2900390","1860","Missouri","290","Cedar","0390","Cedar",1370566,65448,411839,808,0,20619,52244,275573,72863,348436,211
"G2900410","1860","Missouri","290","Chariton","0410","Chariton",2680166,111170,698934,8553,305,16563,156930,919551,173493,1093044,2839
"G2900430","1860","Missouri","290","Christian","0430","Christian",783906,51492,342555,906,207,22806,48435,239674,71241,310915,229
"G2900450","1860","Missouri","290","Clark","0450","Clark",3046500,101607,575725,2701,215,6898,133124,601490,140022,741512,455
"G2900470","1860","Missouri","290","Clay","0470","Clay",5309271,128726,893813,24770,2335,21227,211521,822101,232748,1054849,3455
"G2900490","1860","Missouri","290","Clinton","0490","Clinton",2834145,79451,409375,8736,1580,16519,88768,523741,105287,629028,1144
"G2900510","1860","Missouri","290","Cole","0510","Cole",1247878,48943,322363,2132,1655,4649,79520,267329,84169,351498,987
"G2900530","1860","Missouri","290","Cooper","0530","Cooper",5186619,167030,1204223,30063,4362,17612,181639,1031219,199251,1230470,3800
"G2900550","1860","Missouri","290","Crawford","0550","Crawford",697264,45187,301576,2941,209,13296,59076,197359,72372,269731,182
"G2900570","1860","Missouri","290","Dade","0570","Dade",1414927,53123,431179,2858,1491,28709,61396,347275,90105,437380,346
"G2900590","1860","Missouri","290","Dallas","0590","Dallas",497821,14807,351306,1429,178,22898,51250,345348,74148,419496,114
"G2900610","1860","Missouri","290","Daviess","0610","Daviess",2526192,92680,490053,6154,201,11304,57480,363541,68784,432325,358
"G2900630","1860","Missouri","290","DeKalb","0630","De Kalb",1495356,44864,273937,5637,1119,9486,54395,311711,63881,375592,137
"G2900650","1860","Missouri","290","Dent","0650","Dent",450605,30684,182801,0,0,7254,38171,144944,45425,190369,156
"G2900670","1860","Missouri","290","Douglas","0670","Douglas",115015,11046,111252,175,0,7310,16275,66759,23585,90344,0
"G2900690","1860","Missouri","290","Dunklin","0690","Dunklin",614457,28255,237017,0,0,6473,40708,548037,47181,595218,171
"G2900710","1860","Missouri","290","Franklin","0710","Franklin",3216300,146640,743174,20096,20,5606,162446,677454,168052,845506,1601
"G2900730","1860","Missouri","290","Gasconade","0730","Gasconade",1326430,78166,332410,6857,9639,16518,71802,324789,88320,413109,76
"G2900750","1860","Missouri","290","Gentry","0750","Gentry",2688986,130125,647926,3868,0,26229,100387,736297,126616,862913,118
"G2900770","1860","Missouri","290","Greene","0770","Greene",3163870,130036,879374,14152,816,50721,173924,820924,224645,1045569,1668
"G2900790","1860","Missouri","290","Grundy","0790","Grundy",1770195,76373,368260,3404,160,26407,69872,441627,96279,537906,285
"G2900810","1860","Missouri","290","Harrison","0810","Harrison",1514849,74135,371129,2244,0,15080,58373,472643,73453,546096,25
"G2900830","1860","Missouri","290","Henry","0830","Henry",2704097,106341,717059,8704,180,24545,105374,569238,129919,699157,1245
"G2900850","1860","Missouri","290","Hickory","0850","Hickory",825491,40081,294218,2355,100,11255,36178,190535,47433,237968,195
"G2900870","1860","Missouri","290","Holt","0870","Holt",1314860,51733,267448,2461,5897,8657,48719,309535,57376,366911,309
"G2900890","1860","Missouri","290","Howard","0890","Howard",4157312,196805,1179545,35219,4038,43263,232402,1194203,275665,1469868,5886
"G2900910","1860","Missouri","290","Howell","0910","Howell",204475,21588,98571,0,5,9033,17606,70673,26639,97312,36
"G2900930","1860","Missouri","290","Iron","0930","Iron",620510,25191,138677,4342,697,4895,31407,104556,36302,140858,313
"G2900950","1860","Missouri","290","Jackson","0950","Jackson",5621815,137058,1046802,21499,24150,21837,215195,943019,237032,1180051,3944
"G2900970","1860","Missouri","290","Jasper","0970","Jasper",1231883,68916,399801,3256,50,19161,61624,375999,80785,456784,335
"G2900990","1860","Missouri","290","Jefferson","0990","Jefferson",2416360,74999,418818,9453,11179,2732,100638,322647,103370,426017,564
"G2901010","1860","Missouri","290","Johnson","1010","Johnson",4233771,179614,1062153,19804,200,33690,148292,835607,181982,1017589,1896
"G2901030","1860","Missouri","290","Knox","1030","Knox",1195880,66944,245157,1598,100,14902,83347,428361,98249,526610,284
"G2901050","1860","Missouri","290","Laclede","1050","Laclede",553361,12696,197424,143,35,9381,36688,173296,46069,219365,305
"G2901070","1860","Missouri","290","Lafayette","1070","Lafayette",7782352,209513,1080333,17567,8950,13629,250943,1437267,264572,1701839,6374
"G2901090","1860","Missouri","290","Lawrence","1090","Lawrence",1298875,65193,428766,1598,15,19253,60114,372384,79367,451751,284
"G2901110","1860","Missouri","290","Lewis","1110","Lewis",3287203,104241,666894,7789,2183,19944,142048,654701,161992,816693,1279
"G2901130","1860","Missouri","290","Lincoln","1130","Lincoln",4240348,153070,1121062,18489,0,29369,170611,731319,199980,931299,2840
"G2901150","1860","Missouri","290","Linn","1150","Linn",2003723,78930,439130,5129,26,20354,80264,395983,100618,496601,577
"G2901170","1860","Missouri","290","Livingston","1170","Livingston",1475367,62306,380007,3481,9890,17155,67750,370406,84905,455311,605
"G2901190","1860","Missouri","290","McDonald","1190","Mcdonald",416480,33538,134560,711,40,14982,30642,149778,45624,195402,72
"G2901210","1860","Missouri","290","Macon","1210","Macon",2661038,116496,743385,9791,9320,37411,137616,771585,175027,946612,660
"G2901230","1860","Missouri","290","Madison","1230","Madison",384725,35206,161310,5113,273,7544,40347,135116,47891,183007,467
"G2901250","1860","Missouri","290","Maries","1250","Maries",686907,46539,278413,3018,1224,13979,47272,189293,61251,250544,64
"G2901270","1860","Missouri","290","Marion","1270","Marion",4112761,114446,865530,18617,6626,20925,177843,830696,198768,1029464,3017
"G2901290","1860","Missouri","290","Mercer","1290","Mercer",1581530,80879,414000,4958,197,30938,80477,455032,111415,566447,24
"G2901310","1860","Missouri","290","Miller","1310","Miller",952880,41176,319995,3838,0,17131,50925,216468,68056,284524,238
"G2901330","1860","Missouri","290","Mississippi","1330","Mississippi",1381300,47725,243365,3090,200,1800,54450,282418,56250,338668,1010
"G2901350","1860","Missouri","290","Moniteau","1350","Moniteau",2345884,97539,560058,2043,1520,17304,91812,439116,109116,548232,745
"G2901370","1860","Missouri","290","Monroe","1370","Monroe",2973424,135656,862753,7696,0,33271,139051,843589,172322,1015911,3021
"G2901390","1860","Missouri","290","Montgomery","1390","Montgomery",2330660,95873,566422,7473,1776,13570,89867,477107,103437,580544,1647
"G2901410","1860","Missouri","290","Morgan","1410","Morgan",1572007,62694,444147,4031,5,13230,61490,299677,74720,374397,649
"G2901430","1860","Missouri","290","New Madrid","1430","New Madrid",1688142,41765,279935,0,0,0,0,352074,0,352074,1777
"G2901450","1860","Missouri","290","Newton","1450","Newton",883612,52746,340579,1178,20,12131,51215,268329,63346,331675,426
"G2901470","1860","Missouri","290","Nodaway","1470","Nodaway",682495,22115,136200,0,0,13170,25159,188779,38329,227108,127
"G2901490","1860","Missouri","290","Oregon","1490","Oregon",256350,15766,114681,135,0,6834,15706,86777,22540,109317,26
"G2901510","1860","Missouri","290","Osage","1510","Osage",1369166,59993,407683,2098,100,23481,83385,312183,106866,419049,256
"G2901530","1860","Missouri","290","Ozark","1530","Ozark",84370,5127,109164,100,0,5848,17030,65773,22878,88651,43
"G2901550","1860","Missouri","290","Pemiscot","1550","Pemiscot",578915,18108,161043,415,125,1907,29524,106039,31431,137470,268
"G2901570","1860","Missouri","290","Perry","1570","Perry",1482013,71666,304525,18968,1137,15033,62063,346136,77096,423232,739
"G2901590","1860","Missouri","290","Pettis","1590","Pettis",4479867,110506,833644,11570,246,13359,110350,631340,123709,755049,1882
"G2901610","1860","Missouri","290","Phelps","1610","Phelps",332235,38934,258689,3840,699,11802,76856,182052,88658,270710,84
"G2901630","1860","Missouri","290","Pike","1630","Pike",4974715,169235,1013863,15138,2006,46157,231547,1049680,277704,1327384,4055
"G2901650","1860","Missouri","290","Platte","1650","Platte",5584476,170563,913694,38199,2138,24702,251702,1219961,276404,1496365,3313
"G2901670","1860","Missouri","290","Polk","1670","Polk",1694126,77638,590028,3440,300,35335,81423,427707,116758,544465,512
"G2901690","1860","Missouri","290","Pulaski","1690","Pulaski",300605,17866,148475,140,0,5187,28330,120646,33517,154163,56
"G2901710","1860","Missouri","290","Putnam","1710","Putnam",1330615,66722,348325,383,453,26119,59793,451087,85912,536999,31
"G2901730","1860","Missouri","290","Ralls","1730","Ralls",2813403,99557,704008,10192,950,26224,114701,530041,140925,670966,1791
"G2901750","1860","Missouri","290","Randolph","1750","Randolph",3191090,126005,846966,9578,1230,21494,120802,775487,142296,917783,2619
"G2901770","1860","Missouri","290","Ray","1770","Ray",3681350,133895,1168130,16789,575,110115,254344,954504,364459,1318963,2047
"G2901790","1860","Missouri","290","Reynolds","1790","Reynolds",330110,16214,139061,246,95,6624,26756,87195,33380,120575,38
"G2901810","1860","Missouri","290","Ripley","1810","Ripley",273280,17634,130547,241,0,9276,30127,72620,39403,112023,78
"G2901830","1860","Missouri","290","St Charles","1830","St Charles",4457541,151718,639831,22878,1628,3666,150006,840644,153672,994316,2181
"G2901850","1860","Missouri","290","St Clair","1850","St Clair",861725,47187,203160,1530,71,6602,41059,220059,47661,267720,574
"G2901860","1860","Missouri","290","Ste Genevieve","1860","Ste Genevieve",1055765,63908,282102,13782,30,6917,62861,284921,69778,354699,617
"G2901870","1860","Missouri","290","St Francois","1870","St Francois",1132682,52202,311378,11051,0,14123,68298,239125,82421,321546,877
"G2901890","1860","Missouri","290","St Louis","1890","St Louis",15987064,245238,913866,41579,163274,180,114375,1277581,114555,1392136,4346
"G2901950","1860","Missouri","290","Saline","1950","Saline",5550792,170999,1199206,13155,4010,15276,203617,1470709,218893,1689602,4876
"G2901970","1860","Missouri","290","Schuyler","1970","Schuyler",936425,55452,321769,405,0,18540,54586,288383,73126,361509,39
"G2901990","1860","Missouri","290","Scotland","1990","Scotland",1471789,70232,351443,1620,160,15572,79274,415126,94846,509972,131
"G2902010","1860","Missouri","290","Scott","2010","Scott",626323,42353,171033,1423,0,2323,43385,202166,45708,247874,503
"G2902030","1860","Missouri","290","Shannon","2030","Shannon",411200,19931,121555,275,30,10507,30260,686593,40767,727360,13
"G2902050","1860","Missouri","290","Shelby","2050","Shelby",2892020,116223,674545,4187,2470,52025,158838,612224,210863,823087,724
"G2902070","1860","Missouri","290","Stoddard","2070","Stoddard",859544,38757,249030,1401,2415,11486,44094,1284054,55580,1339634,215
"G2902090","1860","Missouri","290","Stone","2090","Stone",157822,10499,140112,738,233,5596,22862,99548,28458,128006,16
"G2902110","1860","Missouri","290","Sullivan","2110","Sullivan",2271606,91915,481169,1739,799,37847,76988,387173,114835,502008,102
"G2902130","1860","Missouri","290","Taney","2130","Taney",209879,25592,218086,258,15,9266,29100,124918,38366,163284,82
"G2902150","1860","Missouri","290","Texas","2150","Texas",594772,37385,237898,172,63,12939,41220,169307,54159,223466,56
"G2902170","1860","Missouri","290","Vernon","2170","Vernon",1091776,53882,316303,1273,420,25939,52032,212818,77971,290789,136
"G2902190","1860","Missouri","290","Warren","2190","Warren",1909747,86952,456621,9488,238,7317,122598,526498,129915,656413,1034
"G2902210","1860","Missouri","290","Washington","2210","Washington",1239070,53606,332549,8875,10,10930,63598,198722,74528,273250,1028
"G2902230","1860","Missouri","290","Wayne","2230","Wayne",660401,55033,242623,1361,20,23639,59331,232846,82970,315816,261
"G2902250","1860","Missouri","290","Webster","2250","Webster",764390,43494,380187,1516,0,15657,40143,239793,55800,295593,220
"G2902290","1860","Missouri","290","Wright","2290","Wright",380840,22751,156063,935,51,10294,27669,139421,37963,177384,66
"G3150015","1860","Nebraska Territory","315","Buffalo","0015","Buffalo",14300,1510,5290,0,300,0,0,15983,0,15983,
"G3150035","1860","Nebraska Territory","315","Burt","0035","Burt",41490,3705,15749,0,0,0,2202,24904,2202,27106,
"G3150055","1860","Nebraska Territory","315","Butler","0055","Butler",,,,,,,,,,,
"G3150075","1860","Nebraska Territory","315","Calhoun","0075","Calhoun",4180,305,1185,0,0,0,20,938,20,958,
"G3150095","1860","Nebraska Territory","315","Cass","0095","Cass",518381,23421,100075,0,0,11823,19684,252581,31507,284088,
"G3150115","1860","Nebraska Territory","315","Cedar","0115","Cedar",8590,1225,7575,0,0,0,515,5835,515,6350,
"G3150135","1860","Nebraska Territory","315","Clay","0135","Clay",21800,32300,11810,0,0,0,817,5911,817,6728,
"G3150155","1860","Nebraska Territory","315","Cuming","0155","Cuming",4120,750,2494,0,0,0,162,2841,162,3003,
"G3150175","1860","Nebraska Territory","315","Dakota","0175","Dakota",57950,7632,31365,0,1000,0,4672,42058,4672,46730,
"G3150195","1860","Nebraska Territory","315","Dawson","0195","Dawson",,,,,,,,,,,
"G3150215","1860","Nebraska Territory","315","Dixon","0215","Dixon",12380,1815,10205,0,0,0,959,12371,959,13330,
"G3150235","1860","Nebraska Territory","315","Dodge","0235","Dodge",49155,4316,14034,0,0,15,1464,22662,1479,24141,
"G3150255","1860","Nebraska Territory","315","Douglas","0255","Douglas",305510,11093,41895,0,2965,110,3856,76993,3966,80959,
"G3150275","1860","Nebraska Territory","315","Gage","0275","Gage",18595,1786,7530,0,0,0,1319,10554,1319,11873,
"G3150295","1860","Nebraska Territory","315","Greene","0295","Greene",0,0,1235,0,0,0,0,0,0,0,
"G3150315","1860","Nebraska Territory","315","Hall","0315","Hall",23150,2940,9840,0,200,0,0,26497,0,26497,
"G3150335","1860","Nebraska Territory","315","Johnson/Johnston","0335","Johnson/Johnston",60822,4661,22047,0,0,0,1717,27211,1717,28928,
"G3150355","1860","Nebraska Territory","315","Jones","0355","Jones",1000,150,750,0,0,0,120,1344,120,1464,
"G3150375","1860","Nebraska Territory","315","Kearney","0375","Kearney",,,,,,,,,,,5
"G3150395","1860","Nebraska Territory","315","Lancaster","0395","Lancaster",11000,1965,7345,0,0,0,650,6267,650,6917,
"G3150415","1860","Nebraska Territory","315","L'Eau Qui Court","0415","L'Eau Qui",7210,735,2605,0,0,0,65,8685,65,8750,
"G3150435","1860","Nebraska Territory","315","Madison","0435","Madison",,,,,,,,,,,
"G3150455","1860","Nebraska Territory","315","Merrick","0455","Merrick",6500,375,4350,0,0,0,0,7736,0,7736,
"G3150475","1860","Nebraska Territory","315","Nemaha","0475","Nemaha",392655,21130,104286,0,370,0,14010,138624,14010,152634,
"G3150495","1860","Nebraska Territory","315","Nuckolls","0495","Nuckolls",,,,,,,,,,,
"G3150515","1860","Nebraska Territory","315","Otoe","0515","Otoe",1369770,27815,474302,75,991,0,14761,197561,14761,212322,10
"G3150535","1860","Nebraska Territory","315","Pawnee","0535","Pawnee",93300,4938,29571,0,0,24,4670,45807,4694,50501,
"G3150575","1860","Nebraska Territory","315","Platte","0575","Platte",35260,6123,22736,0,25,0,1853,27961,1853,29814,
"G3150595","1860","Nebraska Territory","315","Polk","0595","Polk",,,,,,,,,,,
"G3150615","1860","Nebraska Territory","315","Richardson","0615","Richardson",352505,20958,107097,0,0,913,13913,103647,14826,118473,
"G3150635","1860","Nebraska Territory","315","Saline","0635","Saline",0,260,2610,0,0,0,0,40,0,40,
"G3150655","1860","Nebraska Territory","315","Sarpy","0655","Sarpy",313753,14716,58148,0,4438,370,7208,79910,7578,87488,
"G3150675","1860","Nebraska Territory","315","Shorter","0675","Shorter",,,,,,,,,,,
"G3150715","1860","Nebraska Territory","315","Washington","0715","Washington",127950,9040,32642,50,293,2740,3162,54675,5902,60577,
"G3300010","1860","New Hampshire","330","Belknap","0010","Belknap",4215670,141751,725991,28364,2380,1951,112311,860550,114262,974812,
"G3300030","1860","New Hampshire","330","Carroll","0030","Carroll",3699599,168047,824894,37226,155,9716,110907,1014500,120623,1135123,
"G3300050","1860","New Hampshire","330","Cheshire","0050","Cheshire",5981036,253127,1007753,22222,1944,26062,185739,1204086,211801,1415887,
"G3300070","1860","New Hampshire","330","Coos","0070","Coos",2806160,173551,610311,384,13325,11475,97426,951613,108901,1060514,
"G3300090","1860","New Hampshire","330","Grafton","0090","Grafton",9972260,470166,2074264,38273,5616,127320,310462,2584181,437782,3021963,
"G3300110","1860","New Hampshire","330","Hillsborough","0110","Hillsborough",10279306,362733,1387973,88346,22018,4977,393444,1699052,398421,2097473,
"G3300130","1860","New Hampshire","330","Merrimack","0130","Merrimack",10213110,366214,1482770,216273,6096,3054,2026320,1916371,2029374,3945745,
"G3300150","1860","New Hampshire","330","Rockingham","0150","Rockingham",11790310,379749,1222351,87017,14015,54757,262022,1562098,316779,1878877,
"G3300170","1860","New Hampshire","330","Strafford","0170","Strafford",5931755,217015,686349,26925,9997,3527,132760,848490,136287,984777,
"G3300190","1860","New Hampshire","330","Sullivan","0190","Sullivan",4800555,150659,901971,12904,710,8213,156109,1114227,164322,1278549,
"G3400010","1860","New Jersey","340","Atlantic","0010","Atlantic",686250,14709,79002,494,4134,511,24522,145485,25033,170518,
"G3400030","1860","New Jersey","340","Bergen","0030","Bergen",11834826,340845,733476,31632,295540,0,108795,1033426,108795,1142221,
"G3400050","1860","New Jersey","340","Burlington","0050","Burlington",17552540,556411,1727430,53097,267217,375,669126,2696618,669501,3366119,
"G3400070","1860","New Jersey","340","Camden","0070","Camden",5992105,158005,351303,10188,193738,253,136399,997508,136652,1134160,
"G3400090","1860","New Jersey","340","Cape May","0090","Cape May",1462400,66750,174903,1837,10595,1340,55649,303566,56989,360555,
"G3400110","1860","New Jersey","340","Cumberland","0110","Cumberland",4295875,162230,482665,6172,17222,602,150603,1052799,151205,1204004,
"G3400130","1860","New Jersey","340","Essex","0130","Essex",5332075,148218,519745,15104,140669,120,275656,602294,275776,878070,
"G3400150","1860","New Jersey","340","Gloucester","0150","Gloucester",7962445,289636,663806,15522,44500,0,237623,1245032,237623,1482655,
"G3400170","1860","New Jersey","340","Hudson","0170","Hudson",5106350,66815,84205,12063,210765,345,1230,304128,1575,305703,
"G3400190","1860","New Jersey","340","Hunterdon","0190","Hunterdon",15824190,713850,1602383,60227,2401,2994,291661,2358238,294655,2652893,
"G3400210","1860","New Jersey","340","Mercer","0210","Mercer",10714244,366543,859825,54491,37887,0,227216,1372663,227216,1599879,
"G3400230","1860","New Jersey","340","Middlesex","0230","Middlesex",9916006,298142,868691,21046,43029,3079,168307,1255460,171386,1426846,
"G3400250","1860","New Jersey","340","Monmouth","0250","Monmouth",16295970,510785,1397445,25460,133264,250,312853,2208994,313103,2522097,
"G3400270","1860","New Jersey","340","Morris","0270","Morris",10462026,307646,1090484,21243,8600,3777,210856,1513431,214633,1728064,
"G3400290","1860","New Jersey","340","Ocean","0290","Ocean",2318800,78748,257085,1438,5116,5109,103143,353865,108252,462117,
"G3400310","1860","New Jersey","340","Passaic","0310","Passaic",3769895,83865,375596,2434,42040,20,59076,455018,59096,514114,
"G3400330","1860","New Jersey","340","Salem","0330","Salem",10241468,341493,952594,27788,18340,2166,280021,1969019,282187,2251206,
"G3400350","1860","New Jersey","340","Somerset","0350","Somerset",11922420,428124,1091906,26843,3059,990,240685,1698148,241675,1939823,
"G3400370","1860","New Jersey","340","Sussex","0370","Sussex",11105234,296290,1396472,18896,56720,1220,308319,1738923,309539,2048462,
"G3400390","1860","New Jersey","340","Union","0390","Union",4770150,138556,309958,9323,5545,0,41703,430497,41703,472200,
"G3400410","1860","New Jersey","340","Warren","0410","Warren",12685074,378906,1115719,14104,1614,4437,216833,1777969,221270,1999239,
"G3550015","1860","New Mexico Territory","355","Arizona","0015","Arizona",395700,16839,196722,0,2250,5511,30663,362970,36174,399144,
"G3550035","1860","New Mexico Territory","355","Bernalillo","0035","Bernalillo",321582,23434,1050263,4648,6074,107,51625,62013,51732,113745,
"G3550115","1860","New Mexico Territory","355","Dona Ana","0115","Dona Ana",180540,12069,188525,1200,50,0,7848,59407,7848,67255,
"G3550255","1860","New Mexico Territory","355","Mora","0255","Mora",90310,7936,248523,0,2000,0,11898,43344,11898,55242,
"G3550315","1860","New Mexico Territory","355","Rio Arriba","0315","Rio Arriba",281488,26999,219972,10128,0,0,15203,79264,15203,94467,
"G3550395","1860","New Mexico Territory","355","San Miguel","0395","San Miguel",559296,55297,638554,150,0,18514,41804,66834,60318,127152,
"G3550415","1860","New Mexico Territory","355","Santa Anna","0415","Santa Anna",103263,7358,216311,1995,2810,85,15839,32103,15924,48027,
"G3550435","1860","New Mexico Territory","355","Santa Fe","0435","Santa Fe",181000,5824,210750,75,4430,1975,15790,27024,17765,44789,
"G3550475","1860","New Mexico Territory","355","Socorro","0475","Socorro",183905,6267,298420,1425,10,0,31495,47673,31495,79168,
"G3550495","1860","New Mexico Territory","355","Taos","0495","Taos",230378,22691,526048,0,0,0,26356,109600,26356,135956,
"G3550555","1860","New Mexico Territory","355","Valencia","0555","Valencia",179924,8203,705658,30,40,214,98584,59971,98798,158769,
"G3600010","1860","New York","360","Albany","0010","Albany",15164442,671060,1551840,86359,386241,9182,290904,2645936,300086,2946022,
"G3600030","1860","New York","360","Allegany","0030","Allegany",11188724,435509,1840143,1263,3799,14817,231777,1847675,246594,2094269,
"G3600070","1860","New York","360","Broome","0070","Broome",8671592,322038,1181135,28753,4122,8965,167898,1512874,176863,1689737,
"G3600090","1860","New York","360","Cattaraugus","0090","Cattaraugus",11210206,494571,1889122,10376,15325,19548,235954,1783441,255502,2038943,
"G3600110","1860","New York","360","Cayuga","0110","Cayuga",20584476,810135,2627802,141030,14536,11439,441263,3473844,452702,3926546,
"G3600130","1860","New York","360","Chautauqua","0130","Chautauqua",18419422,693855,2813331,72026,20363,18258,324100,2943607,342358,3285965,
"G3600150","1860","New York","360","Chemung","0150","Chemung",7156967,200166,801240,16641,18125,3719,118278,1128054,121997,1250051,
"G3600170","1860","New York","360","Chenango","0170","Chenango",14750988,694497,2797020,46222,983,20303,283916,3214983,304219,3519202,
"G3600190","1860","New York","360","Clinton","0190","Clinton",6921167,301870,1033132,21747,8619,10222,165932,1352940,176154,1529094,
"G3600210","1860","New York","360","Columbia","0210","Columbia",21270066,727351,2080621,58865,24873,5057,443341,2726621,448398,3175019,
"G3600230","1860","New York","360","Cortland","0230","Cortland",9846986,378467,1680988,29496,8347,11182,211617,2072802,222799,2295601,
"G3600250","1860","New York","360","Delaware","0250","Delaware",11967050,547028,2708833,27812,360,22833,276277,3053195,299110,3352305,
"G3600270","1860","New York","360","Dutchess","0270","Dutchess",30005990,945810,3137733,92189,20880,2241,620418,2989759,622659,3612418,
"G3600290","1860","New York","360","Erie","0290","Erie",19935212,898953,2467395,52390,39796,23627,315661,2520029,339288,2859317,
"G3600310","1860","New York","360","Essex","0310","Essex",4709701,201418,1016169,26953,6092,21832,152465,1033192,174297,1207489,
"G3600330","1860","New York","360","Franklin","0330","Franklin",6384796,332380,1130943,7554,654,23007,151688,1647228,174695,1821923,
"G3600350","1860","New York","360","Fulton","0350","Fulton",4656050,202733,736391,9967,202,1517,118696,933351,120213,1053564,
"G3600370","1860","New York","360","Genesee","0370","Genesee",13885418,485045,1788740,114994,3395,13375,297010,2000833,310385,2311218,
"G3600390","1860","New York","360","Greene","0390","Greene",9975640,311164,1361402,51000,8110,3910,209924,1675990,213834,1889824,
"G3600410","1860","New York","360","Hamilton","0410","Hamilton",321197,20581,88257,542,515,1638,15589,108401,17227,125628,
"G3600430","1860","New York","360","Herkimer","0430","Herkimer",16583798,596937,2338859,30863,284,19630,225282,3436968,244912,3681880,
"G3600450","1860","New York","360","Jefferson","0450","Jefferson",25542788,866040,3441925,45860,8034,34072,398299,4720759,432371,5153130,
"G3600470","1860","New York","360","Kings","0470","Kings",6247950,134210,215171,930,319134,0,10188,751604,10188,761792,
"G3600490","1860","New York","360","Lewis","0490","Lewis",8264029,370217,1404247,8283,124,10606,148287,1906844,158893,2065737,
"G3600510","1860","New York","360","Livingston","0510","Livingston",15987574,654441,2116311,51283,4489,23345,325332,2230708,348677,2579385,
"G3600530","1860","New York","360","Madison","0530","Madison",14251554,535187,2188197,44277,3986,14826,252935,3010819,267761,3278580,
"G3600550","1860","New York","360","Monroe","0550","Monroe",26209862,899561,2862177,367643,476158,7134,628050,4379665,635184,5014849,
"G3600570","1860","New York","360","Montgomery","0570","Montgomery",11632030,452369,1476963,27196,1876,4616,145418,2141039,150034,2291073,
"G3600610","1860","New York","360","New York","0610","New York",9561350,50565,77000,200,392828,0,175,400092,175,400267,
"G3600630","1860","New York","360","Niagara","0630","Niagara",13398984,527530,1818502,243237,24185,15867,313140,2416699,329007,2745706,
"G3600650","1860","New York","360","Oneida","0650","Oneida",23931388,818215,3258968,100016,29530,18160,563222,4339722,581382,4921104,
"G3600670","1860","New York","360","Onondaga","0670","Onondaga",23959116,851939,2914556,106698,64774,10394,464389,4151612,474783,4626395,
"G3600690","1860","New York","360","Ontario","0690","Ontario",18644392,681710,2410328,204373,38915,3734,320999,3155465,324733,3480198,
"G3600710","1860","New York","360","Orange","0710","Orange",21010784,638823,2574411,41271,48815,530,434677,2533259,435207,2968466,
"G3600730","1860","New York","360","Orleans","0730","Orleans",11123724,401313,1470809,227896,2932,3036,253681,1847857,256717,2104574,
"G3600750","1860","New York","360","Oswego","0750","Oswego",12585540,560212,1885609,106992,23768,40310,385642,2352161,425952,2778113,
"G3600770","1860","New York","360","Otsego","0770","Otsego",18807944,664358,2845929,43390,1220,14771,319887,4173318,334658,4507976,
"G3600790","1860","New York","360","Putnam","0790","Putnam",6874210,184420,750020,14113,1070,1731,238551,580371,240282,820653,
"G3600810","1860","New York","360","Queens","0810","Queens",18090150,703134,1348919,62146,886934,0,232655,2679916,232655,2912571,
"G3600830","1860","New York","360","Rensselaer","0830","Rensselaer",17774564,634731,1903351,71755,57157,3962,327595,2554557,331557,2886114,
"G3600850","1860","New York","360","Richmond","0850","Richmond",3327800,81245,149651,3712,20227,0,0,171597,0,171597,
"G3600870","1860","New York","360","Rockland","0870","Rockland",4693250,114093,359705,8303,9659,22,61426,351681,61448,413129,
"G3600890","1860","New York","360","St Lawrence","0890","St Lawrence",22442700,942808,3994406,35023,15872,47483,494513,5249057,541996,5791053,
"G3600910","1860","New York","360","Saratoga","0910","Saratoga",14290242,530587,1799822,60190,29786,5453,331093,2231383,336546,2567929,
"G3600930","1860","New York","360","Schenectady","0930","Schenectady",5374039,269213,692213,17016,10332,2609,129552,882080,132161,1014241,
"G3600950","1860","New York","360","Schoharie","0950","Schoharie",10815868,569707,1805927,46757,830,13525,239849,2511632,253374,2765006,
"G3600970","1860","New York","360","Schuyler","0970","Schuyler",8207612,346662,1076662,37569,5879,17944,128182,1326184,146126,1472310,
"G3600990","1860","New York","360","Seneca","0990","Seneca",10851376,381248,1152936,96071,3222,1015,167585,1966762,168600,2135362,
"G3601010","1860","New York","360","Steuben","1010","Steuben",16665992,644377,2600414,32120,10117,89300,353882,3181414,443182,3624596,
"G3601030","1860","New York","360","Suffolk","1030","Suffolk",12641940,378493,1314027,20387,17559,1050,357694,1585812,358744,1944556,
"G3601050","1860","New York","360","Sullivan","1050","Sullivan",5202980,209637,965698,14831,170,6076,143683,1055551,149759,1205310,
"G3601070","1860","New York","360","Tioga","1070","Tioga",7931129,298279,1182028,26376,1362,7892,161543,1458153,169435,1627588,
"G3601090","1860","New York","360","Tompkins","1090","Tompkins",11940774,379177,1526031,70212,4082,4724,202112,2116587,206836,2323423,
"G3601110","1860","New York","360","Ulster","1110","Ulster",14697102,488047,1920322,34870,34499,7503,387846,2171808,395349,2567157,
"G3601130","1860","New York","360","Warren","1130","Warren",2802399,149860,590791,11516,16619,8943,96677,691872,105620,797492,
"G3601150","1860","New York","360","Washington","1150","Washington",16837668,631704,2238701,68614,7689,4873,469263,2814676,474136,3288812,
"G3601170","1860","New York","360","Wayne","1170","Wayne",10951988,371727,1505848,160517,12068,11686,278129,2014188,289815,2304003,
"G3601190","1860","New York","360","Westchester","1190","Westchester",35661624,668945,1953644,151008,200540,323,428376,2211144,428699,2639843,
"G3601210","1860","New York","360","Wyoming","1210","Wyoming",11173680,429598,1730096,62252,6288,9489,201816,1811921,211305,2023226,
"G3601230","1860","New York","360","Yates","1230","Yates",9325620,380745,1262885,74435,3246,4592,147071,1660190,151663,1811853,
"G3700010","1860","North Carolina","370","Alamance","0010","Alamance",1512700,95994,339720,24333,113,12685,107448,419950,120133,540083,3445
"G3700030","1860","North Carolina","370","Alexander","0030","Alexander",656969,34002,224057,10624,0,26066,49335,185385,75401,260786,611
"G3700050","1860","North Carolina","370","Alleghany","0050","Alleghany",482244,19026,157644,1400,45,16269,32455,119314,48724,168038,206
"G3700070","1860","North Carolina","370","Anson","0070","Anson",1711978,74104,621075,250,1731,21479,130986,732576,152465,885041,6951
"G3700090","1860","North Carolina","370","Ashe","0090","Ashe",555503,33942,269543,3168,4,38461,60712,208136,99173,307309,391
"G3700130","1860","North Carolina","370","Beaufort","0130","Beaufort",1139020,35230,230007,327,25,15784,93399,299209,109183,408392,5878
"G3700150","1860","North Carolina","370","Bertie","0150","Bertie",2061153,62057,496106,2969,160,25378,187616,848138,212994,1061132,8185
"G3700170","1860","North Carolina","370","Bladen","0170","Bladen",2244488,87504,335854,1856,125,56028,140924,205064,196952,402016,5327
"G3700190","1860","North Carolina","370","Brunswick","0190","Brunswick",755766,43406,256792,150,0,8799,76497,285480,85296,370776,3631
"G3700210","1860","North Carolina","370","Buncombe","0210","Buncombe",1957951,107463,517201,28074,795,51004,125158,448570,176162,624732,1933
"G3700230","1860","North Carolina","370","Burke","0230","Burke",784793,41066,212419,4197,10,12179,56961,214634,69140,283774,2371
"G3700250","1860","North Carolina","370","Cabarrus","0250","Cabarrus",1812519,93645,396164,5259,32,11898,110290,623150,122188,745338,3040
"G3700270","1860","North Carolina","370","Caldwell","0270","Caldwell",879035,34034,226286,14647,936,21999,54073,211180,76072,287252,1088
"G3700290","1860","North Carolina","370","Camden","0290","Camden",1865734,40421,233400,0,0,6010,65165,285438,71175,356613,2127
"G3700310","1860","North Carolina","370","Carteret","0310","Carteret",411945,10355,67296,660,590,1735,24783,63713,26518,90231,1969
"G3700330","1860","North Carolina","370","Caswell","0330","Caswell",3848743,90094,465294,6425,65,17643,162093,820422,179736,1000158,9355
"G3700350","1860","North Carolina","370","Catawba","0350","Catawba",1715639,85611,386207,15022,90,24704,89221,374718,113925,488643,1664
"G3700370","1860","North Carolina","370","Chatham","0370","Chatham",2354683,129641,678773,13136,91,88983,229403,722565,318386,1040951,6246
"G3700390","1860","North Carolina","370","Cherokee","0390","Cherokee",1337269,41780,329321,3378,30,32907,81576,297529,114483,412012,519
"G3700410","1860","North Carolina","370","Chowan","0410","Chowan",989606,40335,227794,3455,534,6044,67220,297870,73264,371134,3713
"G3700450","1860","North Carolina","370","Cleveland","0450","Cleveland",1310613,70462,397837,5411,3,26961,94883,366284,121844,488128,2131
"G3700470","1860","North Carolina","370","Columbus","0470","Columbus",1081225,36472,263265,9080,0,57032,114856,180529,171888,352417,2463
"G3700490","1860","North Carolina","370","Craven","0490","Craven",1376387,46754,298227,3137,585,17148,136091,306756,153239,459995,6189
"G3700510","1860","North Carolina","370","Cumberland","0510","Cumberland",1536839,45867,311025,6787,3912,9590,155913,261314,165503,426817,5830
"G3700530","1860","North Carolina","370","Currituck","0530","Currituck",1175485,36446,214721,80,0,10068,75254,318468,85322,403790,2523
"G3700570","1860","North Carolina","370","Davidson","0570","Davidson",1988464,118483,501827,27181,570,23190,159506,663084,182696,845780,3076
"G3700590","1860","North Carolina","370","Davie","0590","Davie",1388642,57756,261811,9466,232,14043,99116,381555,113159,494714,2392
"G3700610","1860","North Carolina","370","Duplin","0610","Duplin",3131621,84417,493346,2311,286,67019,222545,500101,289564,789665,7124
"G3700650","1860","North Carolina","370","Edgecombe","0650","Edgecombe",4974920,196756,772989,11534,1495,80997,324358,1535467,405355,1940822,10108
"G3700670","1860","North Carolina","370","Forsyth","0670","Forsyth",1174800,89026,348933,34446,32,18192,115800,534214,133992,668206,1764
"G3700690","1860","North Carolina","370","Franklin","0690","Franklin",2453259,99969,485158,9911,0,23855,195079,725151,218934,944085,7076
"G3700710","1860","North Carolina","370","Gaston","0710","Gaston",1529274,66267,348143,5616,497,12462,88911,334097,101373,435470,2199
"G3700730","1860","North Carolina","370","Gates","0730","Gates",934908,32370,289154,3907,180,6522,121435,364085,127957,492042,3901
"G3700770","1860","North Carolina","370","Granville","0770","Granville",3457365,127072,688879,1271,10,23755,207001,1127365,230756,1358121,11086
"G3700790","1860","North Carolina","370","Greene","0790","Greene",1658998,46168,289312,2074,0,14400,149121,507014,163521,670535,3947
"G3700810","1860","North Carolina","370","Guilford","0810","Guilford",3406736,150059,682590,24790,9187,25306,221770,741491,247076,988567,3625
"G3700830","1860","North Carolina","370","Halifax","0830","Halifax",3699426,114788,660532,16495,0,23339,215941,1178218,239280,1417498,10349
"G3700850","1860","North Carolina","370","Harnett","0850","Harnett",992531,35131,264142,50,5,16148,121024,199457,137172,336629,2584
"G3700870","1860","North Carolina","370","Haywood","0870","Haywood",730397,35882,248487,19777,0,28590,55247,241957,83837,325794,313
"G3700890","1860","North Carolina","370","Henderson","0890","Henderson",1515097,47340,310665,7509,0,22157,79648,236332,101805,338137,1382
"G3700910","1860","North Carolina","370","Hertford","0910","Hertford",1321818,46582,275925,10032,24,20932,131933,438204,152865,591069,4445
"G3700950","1860","North Carolina","370","Hyde","0950","Hyde",1700075,35121,174530,0,0,0,0,280356,0,280356,2791
"G3700970","1860","North Carolina","370","Iredell","0970","Iredell",2292844,107459,520577,14038,129,29408,135501,530461,164909,695370,4177
"G3700990","1860","North Carolina","370","Jackson","0990","Jackson",616119,22481,199804,3261,0,27188,46984,156505,74172,230677,268
"G3701010","1860","North Carolina","370","Johnston","1010","Johnston",1750771,101770,490421,8915,0,28756,224711,588927,253467,842394,4916
"G3701030","1860","North Carolina","370","Jones","1030","Jones",963266,29282,233426,30,72,6889,84905,246646,91794,338440,3413
"G3701070","1860","North Carolina","370","Lenoir","1070","Lenoir",2432030,56832,346905,645,1295,10767,142429,448818,153196,602014,5140
"G3701090","1860","North Carolina","370","Lincoln","1090","Lincoln",1380259,55090,288591,11015,665,18493,72473,290909,90966,381875,2115
"G3701110","1860","North Carolina","370","McDowell","1110","Mcdowell",774416,31737,203742,700,0,17897,60718,166117,78615,244732,1305
"G3701130","1860","North Carolina","370","Macon","1130","Macon",894577,57897,342127,1338,0,51870,65782,213527,117652,331179,519
"G3701150","1860","North Carolina","370","Madison","1150","Madison",733397,26841,215416,10361,0,27808,51637,205797,79445,285242,213
"G3701170","1860","North Carolina","370","Martin","1170","Martin",1158545,34485,257930,1691,0,6770,100458,385972,107228,493200,4309
"G3701190","1860","North Carolina","370","Mecklenburg","1190","Mecklenburg",2823949,136957,641202,2851,2378,10927,154100,777440,165027,942467,6541
"G3701230","1860","North Carolina","370","Montgomery","1230","Montgomery",359341,49564,239975,5238,0,35102,71419,296901,106521,403422,1823
"G3701250","1860","North Carolina","370","Moore","1250","Moore",1178311,113608,446110,6183,443,34135,130098,348813,164233,513046,2518
"G3701270","1860","North Carolina","370","Nash","1270","Nash",1736608,72064,359516,13266,10,19682,152754,413543,172436,585979,4680
"G3701290","1860","North Carolina","370","New Hanover","1290","New Hanover",1381687,60559,303402,1107,4374,8619,137652,274524,146271,420795,10331
"G3701310","1860","North Carolina","370","Northampton","1310","Northampton",2659031,84905,511693,2641,33,15993,186053,797159,202046,999205,6804
"G3701330","1860","North Carolina","370","Onslow","1330","Onslow",1337923,43361,293758,120,50,24682,135734,309212,160416,469628,3499
"G3701350","1860","North Carolina","370","Orange","1350","Orange",2141690,129292,531353,2514,10,19367,145400,583800,164767,748567,5108
"G3701390","1860","North Carolina","370","Pasquotank","1390","Pasquotank",1927149,45665,272156,199,120,5544,68693,402860,74237,477097,2983
"G3701430","1860","North Carolina","370","Perquimans","1430","Perquimans",1537770,47594,267372,976,25,7744,110528,463958,118272,582230,3558
"G3701450","1860","North Carolina","370","Person","1450","Person",1915505,57558,344788,925,225,18392,105208,543038,123600,666638,5195
"G3701470","1860","North Carolina","370","Pitt","1470","Pitt",3052010,78757,507867,6520,353,22945,246952,925302,269897,1195199,8473
"G3701490","1860","North Carolina","370","Polk","1490","Polk",435684,20011,123164,1297,19,15561,41548,115461,57109,172570,620
"G3701510","1860","North Carolina","370","Randolph","1510","Randolph",1791483,152957,580709,31118,376,47299,177105,594736,224404,819140,1645
"G3701530","1860","North Carolina","370","Richmond","1530","Richmond",2117985,112728,343971,8463,95,13187,148415,536589,161602,698191,5453
"G3701550","1860","North Carolina","370","Robeson","1550","Robeson",2355987,98868,502200,105,170,38017,193472,478867,231489,710356,5455
"G3701570","1860","North Carolina","370","Rockingham","1570","Rockingham",2628246,82752,407484,4937,0,16262,124461,636706,140723,777429,6318
"G3701590","1860","North Carolina","370","Rowan","1590","Rowan",2924631,148147,561799,8534,5966,10827,143174,952369,154001,1106371,3930
"G3701610","1860","North Carolina","370","Rutherford","1610","Rutherford",1100656,72968,316555,6792,0,21158,85100,299758,106258,406016,2391
"G3701630","1860","North Carolina","370","Sampson","1630","Sampson",3110749,65214,501839,3476,0,46265,265900,534754,312165,846919,7028
"G3701670","1860","North Carolina","370","Stanly","1670","Stanly",642061,52045,250155,2179,22,19908,62056,266393,81964,348357,1169
"G3701690","1860","North Carolina","370","Stokes","1690","Stokes",983387,42996,273245,11940,0,19577,83751,375215,103328,478543,2469
"G3701710","1860","North Carolina","370","Surry","1710","Surry",1212733,44457,262455,16399,3,24717,84123,383402,108840,492242,1246
"G3701770","1860","North Carolina","370","Tyrrell","1770","Tyrrell",455845,21249,115705,271,0,5882,45652,191388,51534,242922,1597
"G3701790","1860","North Carolina","370","Union","1790","Union",1293504,103786,427607,4251,6306,32404,106283,431462,138687,570149,2246
"G3701830","1860","North Carolina","370","Wake","1830","Wake",3246866,151291,823523,13798,3002,38942,291657,1014860,330599,1345459,10733
"G3701850","1860","North Carolina","370","Warren","1850","Warren",3338899,143563,560253,700,180,22585,160194,1003089,182779,1185868,10401
"G3701870","1860","North Carolina","370","Washington","1870","Washington",704919,25642,160912,823,559,7605,61581,215681,69186,284867,2465
"G3701890","1860","North Carolina","370","Watauga","1890","Watauga",532532,43798,175426,12565,13410,41994,39058,204039,81052,285091,104
"G3701910","1860","North Carolina","370","Wayne","1910","Wayne",3012511,68245,455664,1707,325,18957,255176,675164,274133,949297,5451
"G3701930","1860","North Carolina","370","Wilkes","1930","Wilkes",1185765,46669,340524,28756,0,35804,106902,313771,142706,456477,1208
"G3701950","1860","North Carolina","370","Wilson","1950","Wilson",1511672,24602,243264,3576,0,10174,119675,357101,129849,486950,3496
"G3701970","1860","North Carolina","370","Yadkin","1970","Yadkin",1106415,54110,300713,15527,227,28192,86421,303736,114613,418349,1436
"G3701990","1860","North Carolina","370","Yancey","1990","Yancey",944719,35188,333056,21745,12427,43316,71906,284537,115222,399759,362
"G3900010","1860","Ohio","390","Adams","0010","Adams",5257360,146653,747012,20974,360,9476,139153,1078351,148629,1226980,
"G3900030","1860","Ohio","390","Allen","0030","Allen",4769391,138067,607157,20175,95,13732,119440,871393,133172,1004565,
"G3900050","1860","Ohio","390","Ashland","0050","Ashland",9230604,239325,1201395,25306,45,2640,107223,1243462,109863,1353325,
"G3900070","1860","Ohio","390","Ashtabula","0070","Ashtabula",7560617,188559,1178702,41594,125,26708,115864,1306638,142572,1449210,
"G3900090","1860","Ohio","390","Athens","0090","Athens",4980034,156646,748589,17799,4543,15978,122375,941924,138353,1080277,
"G3900110","1860","Ohio","390","Auglaize","0110","Auglaize",3738720,155626,546645,17849,916,7060,116708,691143,123768,814911,
"G3900130","1860","Ohio","390","Belmont","0130","Belmont",8870648,214547,1072401,37196,23411,4396,188163,1473663,192559,1666222,
"G3900150","1860","Ohio","390","Brown","0150","Brown",8685636,204429,1090551,10367,14048,14316,213916,1626235,228232,1854467,
"G3900170","1860","Ohio","390","Butler","0170","Butler",19049044,421370,1333592,15592,8692,3555,318274,2587304,321829,2909133,
"G3900190","1860","Ohio","390","Carroll","0190","Carroll",5802027,184371,769269,3055,871,2451,149157,876569,151608,1028177,
"G3900210","1860","Ohio","390","Champaign","0210","Champaign",9074012,184460,979172,34908,4455,2718,142136,1256935,144854,1401789,
"G3900230","1860","Ohio","390","Clark","0230","Clark",10916392,277165,1149065,25620,7695,2557,192029,1406340,194586,1600926,
"G3900250","1860","Ohio","390","Clermont","0250","Clermont",12365912,350272,1097264,27003,5877,8558,288462,1611574,297020,1908594,
"G3900270","1860","Ohio","390","Clinton","0270","Clinton",10492578,298691,1182379,16695,525,1094,282839,1519639,283933,1803572,
"G3900290","1860","Ohio","390","Columbiana","0290","Columbiana",9651074,198635,1094809,9479,1225,4535,180555,1128730,185090,1313820,
"G3900310","1860","Ohio","390","Coshocton","0310","Coshocton",8074539,162838,1005897,16484,50,6422,153142,1132761,159564,1292325,
"G3900330","1860","Ohio","390","Crawford","0330","Crawford",7535419,210982,909828,36444,765,5694,141548,1210707,147242,1357949,
"G3900350","1860","Ohio","390","Cuyahoga","0350","Cuyahoga",11342820,274761,1178811,67437,61692,3065,201993,1461304,205058,1666362,
"G3900370","1860","Ohio","390","Darke","0370","Darke",7822455,234578,822805,16928,858,7152,192715,1198368,199867,1398235,
"G3900390","1860","Ohio","390","Defiance","0390","Defiance",2565397,68399,359807,8163,918,5206,76881,563269,82087,645356,
"G3900410","1860","Ohio","390","Delaware","0410","Delaware",7736033,174313,905519,6765,242,20077,120255,1038233,140332,1178565,
"G3900430","1860","Ohio","390","Erie","0430","Erie",5370397,207318,633138,52252,12279,2837,106241,1154206,109078,1263284,
"G3900450","1860","Ohio","390","Fairfield","0450","Fairfield",10624964,247580,1225229,23578,8049,10232,208838,1651641,219070,1870711,
"G3900470","1860","Ohio","390","Fayette","0470","Fayette",8195860,136967,1190668,10182,865,1905,111169,1129974,113074,1243048,
"G3900490","1860","Ohio","390","Franklin","0490","Franklin",13123092,287879,1442879,22761,31855,9325,218475,1784140,227800,2011940,
"G3900510","1860","Ohio","390","Fulton","0510","Fulton",3186131,111345,524452,19367,217,4367,96788,770714,101155,871869,
"G3900530","1860","Ohio","390","Gallia","0530","Gallia",3451711,125238,546341,24737,1650,21374,120578,873473,141952,1015425,
"G3900550","1860","Ohio","390","Geauga","0550","Geauga",5946630,262507,1177207,24254,1258,6453,89322,1303582,95775,1399357,
"G3900570","1860","Ohio","390","Greene","0570","Greene",11102030,195944,989033,16939,4380,453,221439,1448869,221892,1670761,
"G3900590","1860","Ohio","390","Guernsey","0590","Guernsey",6879974,153352,1024372,10556,861,7027,160655,1066426,167682,1234108,
"G3900610","1860","Ohio","390","Hamilton","0610","Hamilton",23332210,388144,1343978,26653,459196,10593,387823,2279401,398416,2677817,
"G3900630","1860","Ohio","390","Hancock","0630","Hancock",7142981,183050,910533,29079,277,6866,143975,1489718,150841,1640559,
"G3900650","1860","Ohio","390","Hardin","0650","Hardin",3396493,79470,468206,7115,69,3434,73679,540178,77113,617291,
"G3900670","1860","Ohio","390","Harrison","0670","Harrison",6960795,133952,884831,13043,35,1371,100824,959333,102195,1061528,
"G3900690","1860","Ohio","390","Henry","0690","Henry",1482582,62186,249095,7499,4782,2813,56419,399508,59232,458740,
"G3900710","1860","Ohio","390","Highland","0710","Highland",10845788,193789,1164653,10452,25,5857,165986,1452923,171843,1624766,
"G3900730","1860","Ohio","390","Hocking","0730","Hocking",3386386,99541,492442,2906,3960,19868,101548,672402,121416,793818,
"G3900750","1860","Ohio","390","Holmes","0750","Holmes",7273377,226777,822573,27090,423,4863,128907,1017333,133770,1151103,
"G3900770","1860","Ohio","390","Huron","0770","Huron",9911868,292083,1351673,30820,464,4623,156379,1630561,161002,1791563,
"G3900790","1860","Ohio","390","Jackson","0790","Jackson",3114917,83447,493285,6491,4076,16140,94568,625763,110708,736471,
"G3900810","1860","Ohio","390","Jefferson","0810","Jefferson",7524073,164088,829917,18366,5430,23,93580,862152,93603,955755,
"G3900830","1860","Ohio","390","Knox","0830","Knox",10388122,317874,1338190,17820,3187,5435,148645,1266407,154080,1420487,
"G3900850","1860","Ohio","390","Lake","0850","Lake",5427070,127414,649659,41810,9605,2470,81374,933049,83844,1016893,
"G3900870","1860","Ohio","390","Lawrence","0870","Lawrence",2176874,68800,337856,43779,5354,11464,87807,607739,99271,707010,
"G3900890","1860","Ohio","390","Licking","0890","Licking",13675432,355859,1820577,16941,4484,9198,230089,1910523,239287,2149810,
"G3900910","1860","Ohio","390","Logan","0910","Logan",7296708,139998,872523,29459,50,1650,129955,1098985,131605,1230590,
"G3900930","1860","Ohio","390","Lorain","0930","Lorain",8098485,299025,1390836,68184,2251,2752,197086,1422882,199838,1622720,
"G3900950","1860","Ohio","390","Lucas","0950","Lucas",3160115,95125,369781,21047,24926,166,77309,689341,77475,766816,
"G3900970","1860","Ohio","390","Madison","0970","Madison",7785708,120040,1151309,2689,1000,480,92791,972807,93271,1066078,
"G3900990","1860","Ohio","390","Mahoning","0990","Mahoning",9194650,177987,1177972,948,1440,200,141172,1085840,141372,1227212,
"G3901010","1860","Ohio","390","Marion","1010","Marion",6128526,167489,869106,27614,1584,5985,110552,1106981,116537,1223518,
"G3901030","1860","Ohio","390","Medina","1030","Medina",8644510,280435,1375830,58902,7756,6850,152372,1313062,159222,1472284,
"G3901050","1860","Ohio","390","Meigs","1050","Meigs",3613309,105064,417150,13593,1138,10681,79043,670330,89724,760054,
"G3901070","1860","Ohio","390","Mercer","1070","Mercer",3263331,202431,501741,9680,65,6682,130707,785981,137389,923370,
"G3901090","1860","Ohio","390","Miami","1090","Miami",11246996,345527,997476,30068,9576,3136,207008,1657555,210144,1867699,
"G3901110","1860","Ohio","390","Monroe","1110","Monroe",5062236,128536,743817,23944,215,16275,126102,1223488,142377,1365865,
"G3901130","1860","Ohio","390","Montgomery","1130","Montgomery",18264634,427963,1129486,30344,50758,3196,49957,2662288,53153,2715441,
"G3901150","1860","Ohio","390","Morgan","1150","Morgan",5785357,161758,840663,15692,4782,4919,112419,1094755,117338,1212093,
"G3901170","1860","Ohio","390","Morrow","1170","Morrow",7505514,182880,1046002,35877,91,2804,128801,1099758,131605,1231363,
"G3901190","1860","Ohio","390","Muskingum","1190","Muskingum",10310608,218282,1139424,24139,24008,8631,268629,1478119,277260,1755379,
"G3901210","1860","Ohio","390","Noble","1210","Noble",5434051,151665,759244,16636,81,11485,104676,1158750,116161,1274911,
"G3901230","1860","Ohio","390","Ottawa","1230","Ottawa",2022570,80109,249005,9618,2098,225,66722,378011,66947,444958,
"G3901250","1860","Ohio","390","Paulding","1250","Paulding",540726,17005,100447,1720,78,920,23974,158513,24894,183407,
"G3901270","1860","Ohio","390","Perry","1270","Perry",5960281,129182,795856,3553,26,16389,122933,785102,139322,924424,
"G3901290","1860","Ohio","390","Pickaway","1290","Pickaway",9977416,212136,1282408,12725,5121,5601,227261,1886915,232862,2119777,
"G3901310","1860","Ohio","390","Pike","1310","Pike",3831994,105396,643835,22368,4827,11875,139076,821632,150951,972583,
"G3901330","1860","Ohio","390","Portage","1330","Portage",10924626,239680,1683069,28004,1592,9147,150446,1738478,159593,1898071,
"G3901350","1860","Ohio","390","Preble","1350","Preble",11102552,256789,990183,21281,250,3961,354320,1575268,358281,1933549,
"G3901370","1860","Ohio","390","Putnam","1370","Putnam",3216618,91974,442294,12024,43,4599,103223,731614,107822,839436,
"G3901390","1860","Ohio","390","Richland","1390","Richland",11805542,339801,1383254,48566,675,6454,297990,1603901,304444,1908345,
"G3901410","1860","Ohio","390","Ross","1410","Ross",11981046,246085,1398127,9730,11628,10255,252004,2217668,262259,2479927,
"G3901430","1860","Ohio","390","Sandusky","1430","Sandusky",3925728,142739,432825,58132,809,0,121507,970053,121507,1091560,
"G3901450","1860","Ohio","390","Scioto","1450","Scioto",3347888,142777,413596,7285,11424,4969,88204,840913,93173,934086,
"G3901470","1860","Ohio","390","Seneca","1470","Seneca",10371100,298085,1210200,64611,1373,12643,211883,1962919,224526,2187445,
"G3901490","1860","Ohio","390","Shelby","1490","Shelby",4699322,137926,490851,16306,4400,3991,106878,726123,110869,836992,
"G3901510","1860","Ohio","390","Stark","1510","Stark",14081452,371717,1306905,14072,2672,2281,1523568,1529166,1525849,3055015,
"G3901530","1860","Ohio","390","Summit","1530","Summit",9579954,327453,1132323,27986,1317,1312,159357,1180358,160669,1341027,
"G3901550","1860","Ohio","390","Trumbull","1550","Trumbull",9890406,242827,1573020,4492,317,2035,158287,1821316,160322,1981638,
"G3901570","1860","Ohio","390","Tuscarawas","1570","Tuscarawas",7743502,233573,1064079,17730,2647,9760,192954,1392233,202714,1594947,
"G3901590","1860","Ohio","390","Union","1590","Union",4718795,122851,804639,10617,572,9317,97955,915350,107272,1022622,
"G3901610","1860","Ohio","390","Van Wert","1610","Van Wert",2090190,66142,296000,4578,355,5791,66198,434299,71989,506288,
"G3901630","1860","Ohio","390","Vinton","1630","Vinton",2580130,80412,454376,5102,4248,14234,75883,482873,90117,572990,
"G3901650","1860","Ohio","390","Warren","1650","Warren",14024948,307692,1224740,29084,6568,3410,333466,1815654,336876,2152530,
"G3901670","1860","Ohio","390","Washington","1670","Washington",6755650,221639,904828,32107,6428,13153,184233,1242151,197386,1439537,
"G3901690","1860","Ohio","390","Wayne","1690","Wayne",16159536,417060,1605946,32702,4213,8978,272986,2104344,281964,2386308,
"G3901710","1860","Ohio","390","Williams","1710","Williams",6858880,90063,483657,12305,214,1784,89437,737790,91221,829011,
"G3901730","1860","Ohio","390","Wood","1730","Wood",4187710,164765,625178,22621,3603,2890,136308,953855,139198,1093053,
"G3901750","1860","Ohio","390","Wyandot","1750","Wyandot",5519238,159458,719362,10851,105,7950,112377,833941,120327,954268,
"G4100030","1860","Oregon","410","Benton","0030","Benton",1268818,84095,562099,29134,10610,1283,38439,152038,39722,191760,
"G4100050","1860","Oregon","410","Clackamas","0050","Clackamas",817090,42190,253464,89196,200,150,34607,169844,34757,204601,
"G4100070","1860","Oregon","410","Clatsop","0070","Clatsop",81400,3780,47470,1940,0,0,5330,15272,5330,20602,
"G4100090","1860","Oregon","410","Columbia","0090","Columbia",142352,5212,73408,4647,210,0,7385,22096,7385,29481,
"G4100110","1860","Oregon","410","Coos","0110","Coos",,,,,,,,,,,
"G4100150","1860","Oregon","410","Curry","0150","Curry",29800,1810,49520,0,0,0,7110,1219,7110,8329,
"G4100190","1860","Oregon","410","Douglas","0190","Douglas",820993,52937,488615,3978,19825,155,33571,150025,33726,183751,
"G4100290","1860","Oregon","410","Jackson","0290","Jackson",575950,42300,374480,1025,4250,400,90539,100850,90939,191789,
"G4100330","1860","Oregon","410","Josephine","0330","Josephine",173180,15955,115435,130,4400,0,25905,24837,25905,50742,
"G4100390","1860","Oregon","410","Lane","0390","Lane",991640,63294,460879,10480,1655,2879,49012,128264,51891,180155,
"G4100430","1860","Oregon","410","Linn","0430","Linn",2668033,177042,1007345,64455,3040,35393,84436,337228,119829,457057,
"G4100470","1860","Oregon","410","Marion","0470","Marion",1902426,148109,569047,131843,964,3097,95191,403839,98288,502127,
"G4100510","1860","Oregon","410","Multnomah","0510","Multnomah",766440,28338,150752,19150,4265,0,4339,63685,4339,68024,
"G4100530","1860","Oregon","410","Polk","0530","Polk",1630014,87024,673372,34713,3275,174,39730,180413,39904,220317,
"G4100570","1860","Oregon","410","Tillamook","0570","Tillamook",21418,996,10988,50,0,0,617,2947,617,3564,
"G4100595","1860","Oregon","410","Umpqua","0595","Umpqua",379745,33482,357606,4707,1746,1039,35830,89529,36869,126398,
"G4100650","1860","Oregon","410","Wasco","0650","Wasco",283700,20410,275015,100,18435,0,10380,75774,10380,86154,
"G4100670","1860","Oregon","410","Washington","0670","Washington",1172493,69629,39954,22855,1687,1708,43789,145418,45497,190915,
"G4100710","1860","Oregon","410","Yamhill","0710","Yamhill",1275101,75710,436806,60076,1043,0,42255,217618,42255,259873,
"G4200010","1860","Pennsylvania","420","Adams","0010","Adams",9339120,394523,100499,18031,10162,3178,199649,1981923,202827,2184750,
"G4200030","1860","Pennsylvania","420","Allegheny","0030","Allegheny",25394396,532809,1792173,70270,232311,4307,254714,2416934,259021,2675955,
"G4200050","1860","Pennsylvania","420","Armstrong","0050","Armstrong",6253459,197720,1082159,4555,1259,7379,136684,1134345,144063,1278408,
"G4200070","1860","Pennsylvania","420","Beaver","0070","Beaver",7858586,237603,1024974,17374,8105,5893,143308,1019025,149201,1168226,
"G4200090","1860","Pennsylvania","420","Bedford","0090","Bedford",6324760,235977,804722,23678,3544,12193,147626,1131982,159819,1291801,
"G4200110","1860","Pennsylvania","420","Berks","0110","Berks",26516392,861354,2461025,71145,25439,5377,664806,4408280,670183,5078463,
"G4200130","1860","Pennsylvania","420","Blair","0130","Blair",4995315,140522,551118,10962,737,802,111867,973701,112669,1086370,
"G4200150","1860","Pennsylvania","420","Bradford","0150","Bradford",13459226,475834,2175457,57239,2935,17271,292676,3240034,309947,3549981,
"G4200170","1860","Pennsylvania","420","Bucks","0170","Bucks",28766280,1383538,2553944,119627,33268,3436,588154,4314773,591590,4906363,
"G4200190","1860","Pennsylvania","420","Butler","0190","Butler",9604550,333714,1581738,3148,2518,16072,204146,1678752,220218,1898970,
"G4200210","1860","Pennsylvania","420","Cambria","0210","Cambria",2827438,126577,537268,1387,662,6884,87908,552385,94792,647177,
"G4200250","1860","Pennsylvania","420","Carbon","0250","Carbon",929170,54398,124888,1627,850,475,29752,208621,30227,238848,
"G4200270","1860","Pennsylvania","420","Centre","0270","Centre",7073465,214916,774845,18208,180,635,110946,1244366,111581,1355947,
"G4200290","1860","Pennsylvania","420","Chester","0290","Chester",37243640,1133424,3534983,59055,12229,3706,783811,4462938,787517,5250455,
"G4200310","1860","Pennsylvania","420","Clarion","0310","Clarion",5205455,210693,864576,1565,5,1846,95997,715559,97843,813402,
"G4200330","1860","Pennsylvania","420","Clearfield","0330","Clearfield",3578785,145953,544157,646,100,2149,118775,516395,120924,637319,
"G4200350","1860","Pennsylvania","420","Clinton","0350","Clinton",3343203,100836,332571,8487,332,0,79587,639858,79587,719445,
"G4200370","1860","Pennsylvania","420","Columbia","0370","Columbia",5085413,309965,717774,10635,6041,5453,170709,1250996,176162,1427158,
"G4200390","1860","Pennsylvania","420","Crawford","0390","Crawford",11726962,493887,2119380,3600,10256,31692,240801,2277675,272493,2550168,
"G4200410","1860","Pennsylvania","420","Cumberland","0410","Cumberland",15645318,470916,1353183,29012,9077,8597,271102,2521776,279699,2801475,
"G4200430","1860","Pennsylvania","420","Dauphin","0430","Dauphin",13000746,439680,1039396,43546,62103,54234,280223,2122050,334457,2456507,
"G4200450","1860","Pennsylvania","420","Delaware","0450","Delaware",14795210,390540,1090008,27281,31045,92,376383,1397260,376475,1773735,
"G4200470","1860","Pennsylvania","420","Elk","0470","Elk",676750,37030,108617,0,0,10,17100,121574,17110,138684,
"G4200490","1860","Pennsylvania","420","Erie","0490","Erie",14114964,517346,1806459,88468,2727,7807,279718,2566119,287525,2853644,
"G4200510","1860","Pennsylvania","420","Fayette","0510","Fayette",9794618,255911,1245169,33432,5278,10028,205793,1193487,215821,1409308,
"G4200530","1860","Pennsylvania","420","Forest","0530","Forest",343912,6296,19789,0,0,190,3787,16169,3977,20146,
"G4200550","1860","Pennsylvania","420","Franklin","0550","Franklin",16265894,448716,1440197,32819,1613,18222,268402,2412817,286624,2699441,
"G4200570","1860","Pennsylvania","420","Fulton","0570","Fulton",1725609,68546,253603,4415,375,2410,53192,330796,55602,386398,
"G4200590","1860","Pennsylvania","420","Greene","0590","Greene",7442626,194910,1071778,23896,13,15286,127896,1099973,143182,1243155,
"G4200610","1860","Pennsylvania","420","Huntingdon","0610","Huntingdon",6570952,215349,891683,17763,96,673,144971,1364933,145644,1510577,
"G4200630","1860","Pennsylvania","420","Indiana","0630","Indiana",6847960,301184,1234306,4810,263,22315,185431,1302524,207746,1510270,
"G4200650","1860","Pennsylvania","420","Jefferson","0650","Jefferson",2994868,145423,565187,25,149,8363,99080,508729,107443,616172,
"G4200670","1860","Pennsylvania","420","Juniata","0670","Juniata",3448455,124676,456721,12074,4005,2163,104579,800471,106742,907213,
"G4200710","1860","Pennsylvania","420","Lancaster","0710","Lancaster",52599460,1596332,3744621,69765,25009,6413,935479,7527667,941892,8469560,
"G4200730","1860","Pennsylvania","420","Lawrence","0730","Lawrence",6831599,174490,880144,4695,3537,1150,108927,940416,110077,1050493,
"G4200750","1860","Pennsylvania","420","Lebanon","0750","Lebanon",11289394,388926,873151,24965,98,3217,221616,1784846,224833,2009679,
"G4200770","1860","Pennsylvania","420","Lehigh","0770","Lehigh",15518918,554153,1221730,46514,3838,7311,277901,2066623,285212,2351835,
"G4200790","1860","Pennsylvania","420","Luzerne","0790","Luzerne",12497546,342186,1267040,34508,20112,11411,261410,1941935,272821,2214756,
"G4200810","1860","Pennsylvania","420","Lycoming","0810","Lycoming",7472791,320851,846572,17478,2963,1653,199128,1499874,200781,1700655,
"G4200830","1860","Pennsylvania","420","McKean","0830","Mckean",1441361,58096,253936,0,0,3879,58963,282039,62842,344881,
"G4200850","1860","Pennsylvania","420","Mercer","0850","Mercer",9022238,297462,1505280,3326,12419,13297,178948,1767398,192245,1959643,
"G4200870","1860","Pennsylvania","420","Mifflin","0870","Mifflin",6777256,210437,599661,22224,2204,0,114380,1117293,114380,1231673,
"G4200890","1860","Pennsylvania","420","Monroe","0890","Monroe",2861730,110076,379138,6303,70,3088,91566,588379,94654,683033,
"G4200910","1860","Pennsylvania","420","Montgomery","0910","Montgomery",29564664,1111922,2374615,45420,44862,6662,724563,3789138,731225,4520364,
"G4200930","1860","Pennsylvania","420","Montour","0930","Montour",2703853,80847,246390,2742,631,794,45822,470503,46616,517119,
"G4200950","1860","Pennsylvania","420","Northampton","0950","Northampton",14259636,612346,1168962,16263,4862,1810,260651,2041865,262461,2304326,
"G4200970","1860","Pennsylvania","420","Northumberland","0970","Northumberland",8085626,265085,708109,13490,7656,1112,171297,1464114,172409,1636523,
"G4200990","1860","Pennsylvania","420","Perry","0990","Perry",5494933,254679,691066,21806,6086,7332,146909,1143629,154241,1297870,
"G4201010","1860","Pennsylvania","420","Philadelphia","1010","Philadelphia",26277400,375798,794388,17624,715836,764,79525,1723392,80289,1803681,
"G4201030","1860","Pennsylvania","420","Pike","1030","Pike",1639070,67359,233338,1305,110,30,45853,268943,45883,314826,
"G4201050","1860","Pennsylvania","420","Potter","1050","Potter",1776291,79430,358236,30,40,10811,55688,461360,66499,527859,
"G4201070","1860","Pennsylvania","420","Schuylkill","1070","Schuylkill",7024544,250364,619508,20968,22652,8486,238883,1131088,247369,1378457,
"G4201090","1860","Pennsylvania","420","Snyder","1090","Snyder",3911110,112793,386764,15778,0,2418,90414,761509,92832,854341,
"G4201110","1860","Pennsylvania","420","Somerset","1110","Somerset",8764526,317744,1400709,7770,156,37927,198052,1691444,235979,1927423,
"G4201130","1860","Pennsylvania","420","Sullivan","1130","Sullivan",851328,35194,193417,2637,7,4635,30100,288076,34735,322811,
"G4201150","1860","Pennsylvania","420","Susquehanna","1150","Susquehanna",6115268,320163,1151591,36126,325,17378,150283,1478651,167661,1646312,
"G4201170","1860","Pennsylvania","420","Tioga","1170","Tioga",6246289,248199,1070137,11004,285,8146,160193,1626047,168339,1794386,
"G4201190","1860","Pennsylvania","420","Union","1190","Union",4949388,158559,405275,11941,772,237,84038,836236,84275,920511,
"G4201210","1860","Pennsylvania","420","Venango","1210","Venango",5375713,184042,824669,6941,373,12746,125663,1011591,138409,1150000,
"G4201230","1860","Pennsylvania","420","Warren","1230","Warren",3378135,142894,509084,613,10,3297,81744,504212,85041,589253,
"G4201250","1860","Pennsylvania","420","Washington","1250","Washington",20937686,574434,2731865,53387,5465,36711,279895,2094176,316606,2410782,
"G4201270","1860","Pennsylvania","420","Wayne","1270","Wayne",6410780,414266,1111956,44601,5300,2910,176972,1484560,179882,1664442,
"G4201290","1860","Pennsylvania","420","Westmoreland","1290","Westmoreland",16036204,511700,2106662,44022,18496,30006,362764,2475518,392770,2868288,
"G4201310","1860","Pennsylvania","420","Wyoming","1310","Wyoming",3247140,123850,529310,10969,10,7140,81797,733956,88937,822893,
"G4201330","1860","Pennsylvania","420","York","1330","York",23495340,947399,2231055,45942,13105,12819,480381,3964799,493200,4457999,
"G4400010","1860","Rhode Island","440","Bristol","0010","Bristol",1210830,62603,91471,2132,18036,0,25894,112198,25894,138092,
"G4400030","1860","Rhode Island","440","Kent","0030","Kent",2163828,64493,255162,12608,13003,0,75131,265966,75131,341097,
"G4400050","1860","Rhode Island","440","Newport","0050","Newport",4793065,116221,480087,7420,28131,2755,158174,491544,160929,652473,
"G4400070","1860","Rhode Island","440","Providence","0070","Providence",7912955,224416,718856,54699,74607,4476,324503,821767,328979,1150746,
"G4400090","1860","Rhode Island","440","Washington","0090","Washington",3469875,119058,496468,6832,6514,593,128021,470435,128614,599049,
"G4500010","1860","South Carolina","450","Abbeville","0010","Abbeville",5938301,260078,1242705,1655,0,37186,328204,1683643,365390,2049033,20502
"G4500070","1860","South Carolina","450","Anderson","0070","Anderson",3445350,158400,739575,0,550,86688,233940,771625,320628,1092253,8425
"G4500110","1860","South Carolina","450","Barnwell","0110","Barnwell",9020034,243151,1450479,16882,23873,20036,347389,1910135,367425,2277560,17401
"G4500130","1860","South Carolina","450","Beaufort","0130","Beaufort",9900652,559934,1254608,10401,200,17071,164016,2042326,181087,2223413,32530
"G4500190","1860","South Carolina","450","Charleston","0190","Charleston",5202502,332808,912399,5009,106213,1376,185304,1368239,186680,1554919,37290
"G4500230","1860","South Carolina","450","Chester","0230","Chester",4235265,133063,794190,83,0,10458,177858,1153093,188316,1341409,10868
"G4500250","1860","South Carolina","450","Chesterfield","0250","Chesterfield",1577209,57805,361659,3732,500,10815,103127,448719,113942,562661,4348
"G4500270","1860","South Carolina","450","Clarendon","0270","Clarendon",2281227,89497,407704,9262,0,2323,112166,723772,114489,838261,8566
"G4500290","1860","South Carolina","450","Colleton","0290","Colleton",8818772,430057,1342845,1695,4508,22203,187516,1737041,209719,1946760,32307
"G4500310","1860","South Carolina","450","Darlington","0310","Darlington",4786392,136110,708525,4385,0,535,212799,1285860,213334,1499194,11877
"G4500370","1860","South Carolina","450","Edgefield","0370","Edgefield",8634178,334868,1692717,29891,193,36269,418455,2088989,454724,2543713,24060
"G4500390","1860","South Carolina","450","Fairfield","0390","Fairfield",6314029,218807,998000,18875,35816,11789,337564,1460860,349353,1810213,15534
"G4500430","1860","South Carolina","450","Georgetown","0430","Georgetown",5818690,616774,316710,310,100,25120,36710,1462095,61830,1523925,18109
"G4500450","1860","South Carolina","450","Greenville","0450","Greenville",3693522,180861,720317,2222,22,35663,206298,666605,241961,908566,7049
"G4500510","1860","South Carolina","450","Horry","0510","Horry",863735,44217,258916,425,7,27401,147805,170488,175206,345694,2359
"G4500550","1860","South Carolina","450","Kershaw","0550","Kershaw",2696232,141149,490916,10671,4290,19091,123346,711094,142437,853531,7841
"G4500570","1860","South Carolina","450","Lancaster","0570","Lancaster",2222478,107034,454488,4188,0,22435,115373,777779,137808,915587,5650
"G4500590","1860","South Carolina","450","Laurens","0590","Laurens",5810438,268959,1214797,7273,50,37965,297631,1327851,335596,1663447,13200
"G4500630","1860","South Carolina","450","Lexington","0630","Lexington",3210141,129389,661749,12787,52,24341,160603,607107,184944,792051,6202
"G4500670","1860","South Carolina","450","Marion","0670","Marion",5351580,141076,703357,5360,0,69267,287054,1061380,356321,1417701,9951
"G4500690","1860","South Carolina","450","Marlboro","0690","Marlboro",4063766,162036,516729,2096,0,10280,173134,961914,183414,1145328,6893
"G4500710","1860","South Carolina","450","Newberry","0710","Newberry",5423796,215476,957956,10370,1460,25894,259559,1282414,285453,1567867,13695
"G4500750","1860","South Carolina","450","Orangeburg","0750","Orangeburg",5331097,200733,969351,1770,0,10026,230782,1353301,240808,1594109,16583
"G4500770","1860","South Carolina","450","Pickens","0770","Pickens",3391505,102365,626496,535,290,49879,181444,521996,231323,753319,4195
"G4500790","1860","South Carolina","450","Richland","0790","Richland",2099715,111658,298332,2275,175,1425,37834,666375,39259,705634,11005
"G4500830","1860","South Carolina","450","Spartanburg","0830","Spartanburg",4388642,156009,865620,20298,7764,49823,260210,1000275,310033,1310308,8240
"G4500850","1860","South Carolina","450","Sumter","0850","Sumter",3893683,212368,805311,19190,675,99750,217482,1435859,317232,1753091,16682
"G4500870","1860","South Carolina","450","Union","0870","Union",4747203,133751,693745,9142,10,17391,194977,1154403,212368,1366771,10801
"G4500890","1860","South Carolina","450","Williamsburg","0890","Williamsburg",2404983,87316,593594,0,25,205,126357,579338,126562,705900,10259
"G4500910","1860","South Carolina","450","York","0910","York",4087393,185908,880675,3207,573,32412,207885,994461,240297,1234758,9984
"G4700010","1860","Tennessee","470","Anderson","0010","Anderson",1151340,82056,334939,549,0,25500,73747,282282,99247,381529,583
"G4700030","1860","Tennessee","470","Bedford","0030","Bedford",7071904,156458,1493052,32,835,24157,295384,982346,319541,1301887,6744
"G4700050","1860","Tennessee","470","Benton","0050","Benton",974861,49519,378875,0,0,29415,77728,373248,107143,480391,534
"G4700070","1860","Tennessee","470","Bledsoe","0070","Bledsoe",914642,34715,250825,0,0,16663,44882,195051,61545,256596,689
"G4700090","1860","Tennessee","470","Blount","0090","Blount",3304096,140904,663718,150,0,42117,166723,529709,208840,738549,1363
"G4700110","1860","Tennessee","470","Bradley","0110","Bradley",2669725,91288,403774,775,175,29096,147819,476645,176915,653560,1173
"G4700130","1860","Tennessee","470","Campbell","0130","Campbell",748164,26897,240061,0,35,20332,54865,190345,75197,265542,366
"G4700150","1860","Tennessee","470","Cannon","0150","Cannon",2406561,69154,763453,137,70,68432,146939,369687,215371,585058,974
"G4700170","1860","Tennessee","470","Carroll","0170","Carroll",2715288,114950,728796,115,47,39477,177346,871669,216823,1088492,4064
"G4700190","1860","Tennessee","470","Carter","0190","Carter",1168255,37579,212155,21214,0,30848,54429,238011,85277,323288,374
"G4700210","1860","Tennessee","470","Cheatham","0210","Cheatham",1587451,31870,343012,0,0,8207,84731,233262,92938,326200,1882
"G4700250","1860","Tennessee","470","Claiborne","0250","Claiborne",1558030,58089,467222,7727,10,33858,112086,420175,145944,566119,743
"G4700290","1860","Tennessee","470","Cocke","0290","Cocke",2320967,80149,542853,0,0,39104,109043,451677,148147,599824,849
"G4700310","1860","Tennessee","470","Coffee","0310","Coffee",1795893,52969,472993,10,0,28430,100018,326688,128448,455136,1529
"G4700350","1860","Tennessee","470","Cumberland","0350","Cumberland",268900,12459,116544,535,2000,7239,23113,61799,30352,92151,121
"G4700370","1860","Tennessee","470","Davidson","0370","Davidson",13929974,208101,1694653,3028,102793,17825,253580,945561,271405,1216966,14790
"G4700390","1860","Tennessee","470","Decatur","0390","Decatur",736009,45599,338552,3052,0,49972,73034,250473,123006,373479,784
"G4700410","1860","Tennessee","470","DeKalb","0410","De Kalb",1858285,58819,506233,180,95,92287,94231,324927,186518,511445,1025
"G4700430","1860","Tennessee","470","Dickson","0430","Dickson",1541760,73783,623275,1821,0,31752,114738,357558,146490,504048,2201
"G4700450","1860","Tennessee","470","Dyer","0450","Dyer",2685335,76247,667200,392,0,18257,123007,617173,141264,758437,2641
"G4700470","1860","Tennessee","470","Fayette","0470","Fayette",4661335,237687,1171945,14459,0,22228,224574,2347388,246802,2594190,15473
"G4700490","1860","Tennessee","470","Fentress","0490","Fentress",501776,24576,246675,221,0,19461,42907,124247,62368,186615,187
"G4700510","1860","Tennessee","470","Franklin","0510","Franklin",2772390,82428,783888,0,2305,34988,183658,492350,218646,710996,3551
"G4700530","1860","Tennessee","470","Gibson","0530","Gibson",6758900,195123,1355267,22312,2077,92081,256929,1217665,349010,1566675,6141
"G4700550","1860","Tennessee","470","Giles","0550","Giles",9099460,200229,1728981,1608,0,120030,413224,1312343,533254,1845597,10848
"G4700570","1860","Tennessee","470","Grainger","0570","Grainger",1919203,65384,424788,83,81,25402,116051,411686,141453,553139,1065
"G4700590","1860","Tennessee","470","Greene","0590","Greene",5021755,192253,980817,6158,580,38333,192740,925755,231073,1156828,1297
"G4700610","1860","Tennessee","470","Grundy","0610","Grundy",504332,19725,162609,265,593,9814,31651,109169,41465,150634,266
"G4700650","1860","Tennessee","470","Hamilton","0650","Hamilton",2569445,72263,463942,570,50,21069,126900,428253,147969,576222,1419
"G4700670","1860","Tennessee","470","Hancock","0670","Hancock",1040405,24446,269751,6844,0,19044,53631,215592,72675,288267,246
"G4700690","1860","Tennessee","470","Hardeman","0690","Hardeman",3173184,172297,830457,3770,525,30152,198116,1407796,228268,1636064,7236
"G4700710","1860","Tennessee","470","Hardin","0710","Hardin",1722067,84838,625116,2431,20,47758,138552,378583,186310,564893,1623
"G4700730","1860","Tennessee","470","Hawkins","0730","Hawkins",2810483,86829,710772,2544,0,56819,161742,607290,218561,825851,1925
"G4700750","1860","Tennessee","470","Haywood","0750","Haywood",6624331,192234,973750,14433,175,30935,217361,1806674,248296,2054970,11026
"G4700770","1860","Tennessee","470","Henderson","0770","Henderson",1798197,113935,677337,12659,3470,122477,168486,744729,290963,1035692,3283
"G4700790","1860","Tennessee","470","Henry","0790","Henry",4059828,118830,957199,12975,1442,38718,155405,1126768,194123,1320891,5530
"G4700810","1860","Tennessee","470","Hickman","0810","Hickman",1693224,79313,675811,284,0,24700,103071,359105,127771,486876,1753
"G4700850","1860","Tennessee","470","Humphreys","0850","Humphreys",1568223,53364,478347,319,5,21594,105277,339453,126871,466324,1463
"G4700870","1860","Tennessee","470","Jackson","0870","Jackson",1639505,47696,507323,871,0,32614,107689,427272,140303,567575,1212
"G4700890","1860","Tennessee","470","Jefferson","0890","Jefferson",4224357,170131,411302,0,0,82580,170099,739978,252679,992657,2096
"G4700910","1860","Tennessee","470","Johnson","0910","Johnson",786806,25943,137114,8480,98,19320,33578,120134,52898,173032,233
"G4700930","1860","Tennessee","470","Knox","0930","Knox",4480870,202253,846253,3413,20349,33537,212097,729152,245634,974786,2370
"G4700970","1860","Tennessee","470","Lauderdale","0970","Lauderdale",1857255,67461,462579,0,0,6550,71943,538146,78493,616639,2854
"G4700990","1860","Tennessee","470","Lawrence","0990","Lawrence",1181148,48699,386620,5404,0,27295,71299,3510280,98594,3608874,1160
"G4701010","1860","Tennessee","470","Lewis","1010","Lewis",292050,13492,135380,65,0,7629,19325,63498,26954,90452,247
"G4701030","1860","Tennessee","470","Lincoln","1030","Lincoln",8243905,230773,2029500,3450,276,60443,388521,1222939,448964,1671903,6847
"G4701070","1860","Tennessee","470","McMinn","1070","Mcminn",2962346,129599,649487,141,0,33515,173946,543585,207461,751046,1909
"G4701090","1860","Tennessee","470","McNairy","1090","Mcnairy",1865614,105577,813021,1133,0,41384,187021,668848,228405,897253,1900
"G4701110","1860","Tennessee","470","Macon","1110","Macon",1246301,38837,419524,0,0,7798,57227,564554,65025,629579,929
"G4701130","1860","Tennessee","470","Madison","1130","Madison",5069307,255315,1044553,0,250,35160,260837,1756769,295997,2052766,10012
"G4701150","1860","Tennessee","470","Marion","1150","Marion",1067739,41938,284111,700,190,22143,69383,237227,91526,328753,678
"G4701170","1860","Tennessee","470","Marshall","1170","Marshall",5440318,156181,1498709,486,61,65316,240541,658862,305857,964719,4480
"G4701190","1860","Tennessee","470","Maury","1190","Maury",15153854,281902,3371005,1249,3991,63477,554546,1691950,618023,2309973,14654
"G4701210","1860","Tennessee","470","Meigs","1210","Meigs",1429660,45342,259222,20,0,12749,80775,223901,93524,317425,638
"G4701230","1860","Tennessee","470","Monroe","1230","Monroe",3449290,124854,686677,340,305,46490,168002,820457,214492,1034949,1600
"G4701250","1860","Tennessee","470","Montgomery","1250","Montgomery",6522474,140897,915753,1182,763,10719,246972,1066478,257691,1324169,9554
"G4701290","1860","Tennessee","470","Morgan","1290","Morgan",501805,18788,141205,752,7740,10213,32680,101111,42893,144004,120
"G4701310","1860","Tennessee","470","Obion","1310","Obion",3479477,108009,742748,19531,1315,17705,152158,661614,169863,831477,2399
"G4701330","1860","Tennessee","470","Overton","1330","Overton",1653886,55547,480891,2937,208,41403,93246,365398,134649,500047,1087
"G4701350","1860","Tennessee","470","Perry","1350","Perry",958740,36538,398824,90,30,22845,89523,227889,112368,340257,548
"G4701390","1860","Tennessee","470","Polk","1390","Polk",1076939,34124,181793,21,2837,14393,61657,182223,76050,258273,434
"G4701410","1860","Tennessee","470","Putnam","1410","Putnam",889274,45647,386037,1037,0,39220,80571,266512,119791,386303,682
"G4701430","1860","Tennessee","470","Rhea","1430","Rhea",1171640,42872,258249,58,15,10437,67520,211611,77957,289568,615
"G4701450","1860","Tennessee","470","Roane","1450","Roane",3420610,116275,696065,7850,100,155707,235847,589455,391554,981009,1748
"G4701470","1860","Tennessee","470","Robertson","1470","Robertson",5211402,150094,1025925,3860,483,27137,226454,884496,253591,1138087,4861
"G4701490","1860","Tennessee","470","Rutherford","1490","Rutherford",13468310,265867,2115432,1945,683,63754,427067,1634292,490821,2125113,12984
"G4701510","1860","Tennessee","470","Scott","1510","Scott",203910,12138,109188,331,0,16805,36238,79938,53043,132981,59
"G4701530","1860","Tennessee","470","Sequatchie","1530","Sequatchie",384780,16095,135494,323,0,9232,24607,89255,33839,123094,201
"G4701550","1860","Tennessee","470","Sevier","1550","Sevier",1682698,75150,429474,15,0,31584,80247,369918,111831,481749,538
"G4701570","1860","Tennessee","470","Shelby","1570","Shelby",9428210,250648,1126049,24111,105507,10421,187568,1753322,197989,1951311,16953
"G4701590","1860","Tennessee","470","Smith","1590","Smith",4358147,105645,1098544,57,15,45710,209769,835364,255479,1090843,4228
"G4701610","1860","Tennessee","470","Stewart","1610","Stewart",1108369,52013,414138,1293,90,17529,117675,356211,135204,491415,2415
"G4701630","1860","Tennessee","470","Sullivan","1630","Sullivan",2792803,124692,602550,10324,115,37294,137833,523076,175127,698203,1074
"G4701650","1860","Tennessee","470","Sumner","1650","Sumner",6368096,182397,1596720,11423,33027,83599,317058,959439,400657,1360096,7700
"G4701670","1860","Tennessee","470","Tipton","1670","Tipton",2499118,112121,640992,14760,1713,26461,118251,903073,144712,1047785,5288
"G4701730","1860","Tennessee","470","Union","1730","Union",804440,28874,217906,80,91,15135,57660,184366,72795,257161,182
"G4701750","1860","Tennessee","470","Van Buren","1750","Van Buren",392593,14255,136164,50,0,9739,21465,87696,31204,118900,239
"G4701770","1860","Tennessee","470","Warren","1770","Warren",2125840,63474,507795,0,14,29026,108551,314154,137577,451731,2320
"G4701790","1860","Tennessee","470","Washington","1790","Washington",4531622,154697,672576,15446,696,30086,154075,603736,184161,787897,952
"G4701810","1860","Tennessee","470","Wayne","1810","Wayne",1475887,58043,586501,4420,0,76881,115235,310032,192116,502148,1269
"G4701830","1860","Tennessee","470","Weakley","1830","Weakley",2942005,137807,849665,6870,120,36299,193807,1139215,230106,1369321,4213
"G4701850","1860","Tennessee","470","White","1850","White",1341198,51180,459839,1210,183,18007,83241,298602,101248,399850,1145
"G4701870","1860","Tennessee","470","Williamson","1870","Williamson",10528966,217142,2030341,1863,3520,18829,255037,1347456,273866,1621322,12367
"G4701890","1860","Tennessee","470","Wilson","1890","Wilson",9939448,291411,2592550,5760,1058,222236,414209,1276378,636445,1912823,7964
"G4800010","1860","Texas","480","Anderson","0010","Anderson",1764388,131412,625221,245,0,15594,129186,603854,144780,748634,3668
"G4800050","1860","Texas","480","Angelina","0050","Angelina",469225,34038,268595,0,0,17617,60134,257422,77751,335173,686
"G4800130","1860","Texas","480","Atascosa","0130","Atascosa",94126,7168,284692,0,0,5316,17148,3120,22464,25584,107
"G4800150","1860","Texas","480","Austin","0150","Austin",3797883,120793,1112967,1255,7682,930,115705,1147529,116635,1264164,3914
"G4800190","1860","Texas","480","Bandera","0190","Bandera",20550,2290,22648,0,0,0,1198,0,1198,1198,12
"G4800210","1860","Texas","480","Bastrop","0210","Bastrop",1148154,59599,725462,35,0,800,50075,333656,50875,384531,2591
"G4800230","1860","Texas","480","Baylor","0230","Baylor",,,,,,,,,,,
"G4800250","1860","Texas","480","Bee","0250","Bee",142774,750,284480,0,0,0,6210,5576,6210,11786,79
"G4800270","1860","Texas","480","Bell","0270","Bell",1339192,65171,767680,0,100,2609,34120,112705,36729,149434,1005
"G4800290","1860","Texas","480","Bexar","0290","Bexar",591706,12892,464172,8065,0,0,26679,66777,26679,93456,1395
"G4800310","1860","Texas","480","Blanco","0310","Blanco",576302,13770,356683,0,0,0,8540,22358,8540,30898,98
"G4800350","1860","Texas","480","Bosque","0350","Bosque",156417,9801,226260,0,0,616,9258,22378,9874,32252,293
"G4800370","1860","Texas","480","Bowie","0370","Bowie",1250661,71806,324536,2885,20,5302,72408,462752,77710,540462,2651
"G4800390","1860","Texas","480","Brazoria","0390","Brazoria",4815608,531717,923981,0,0,0,46599,1173956,46599,1220555,5110
"G4800410","1860","Texas","480","Brazos","0410","Brazos",1371702,31472,376014,0,0,0,0,155448,0,155448,1063
"G4800490","1860","Texas","480","Brown","0490","Brown",3015,155,20782,0,0,107,1183,5068,1290,6358,0
"G4800493","1860","Texas","480","Buchanan","0493","Buchanan",3775,1360,53095,0,40,465,6945,1036,7410,8446,32
"G4800510","1860","Texas","480","Burleson","0510","Burleson",1638606,59517,660070,0,0,90,43265,299133,43355,342488,2003
"G4800530","1860","Texas","480","Burnet","0530","Burnet",302289,25892,431280,0,0,499,21274,33085,21773,54858,235
"G4800550","1860","Texas","480","Caldwell","0550","Caldwell",740022,41243,518223,70,1,12836,35147,194515,47983,242498,1610
"G4800570","1860","Texas","480","Calhoun","0570","Calhoun",44400,2875,43364,850,3700,0,850,8150,850,9000,414
"G4800610","1860","Texas","480","Cameron","0610","Cameron",854845,35261,594750,0,1940,1835,49965,99617,51800,151417,7
"G4800655","1860","Texas","480","Cass (old)","0655","Cass (old)",1209853,67317,358463,3991,0,11733,77535,699542,89268,788810,3475
"G4800710","1860","Texas","480","Chambers","0710","Chambers",275488,15515,268062,0,0,0,11684,26847,11684,38531,513
"G4800730","1860","Texas","480","Cherokee","0730","Cherokee",1261459,99089,629261,710,0,10429,118744,598960,129173,728133,3246
"G4800770","1860","Texas","480","Clay","0770","Clay",,,,,,,,,,,0
"G4800830","1860","Texas","480","Coleman","0830","Coleman",,,,,,,,,,,
"G4800850","1860","Texas","480","Collin","0850","Collin",2090058,100115,824286,0,0,14265,90202,346886,104467,451353,1047
"G4800890","1860","Texas","480","Colorado","0890","Colorado",3066070,212416,592512,0,0,0,60281,834471,60281,894752,3559
"G4800910","1860","Texas","480","Comal","0910","Comal",561527,41853,324634,1600,1889,0,19048,104383,19048,123431,193
"G4800930","1860","Texas","480","Comanche","0930","Comanche",49024,6173,150403,0,0,526,9377,7042,9903,16945,61
"G4800950","1860","Texas","480","Concho","0950","Concho",,,,,,,,,,,
"G4800970","1860","Texas","480","Cooke","0970","Cooke",548601,34446,408883,0,8,5286,35851,61682,41137,102819,369
"G4800990","1860","Texas","480","Coryell","0990","Coryell",506593,27420,332010,335,50,5575,23377,64006,28952,92958,306
"G4801130","1860","Texas","480","Dallas","1130","Dallas",2342875,130014,987145,0,0,15191,78056,351684,93247,444931,1074
"G4801155","1860","Texas","480","Dawson","1155","Dawson",,,,,,,,,,,0
"G4801210","1860","Texas","480","Denton","1210","Denton",532037,18485,388434,10,0,6843,27797,67385,34640,102025,251
"G4801230","1860","Texas","480","DeWitt","1230","De Witt",1463556,66880,721826,47,168,150,53403,351305,53553,404858,1643
"G4801270","1860","Texas","480","Dimmit","1270","Dimmit",,,,,,,,,,,
"G4801310","1860","Texas","480","Duval","1310","Duval",,,,,,,,,,,
"G4801330","1860","Texas","480","Eastland","1330","Eastland",18025,2885,52867,0,0,515,5700,4525,6215,10740,0
"G4801370","1860","Texas","480","Edwards","1370","Edwards",,,,,,,,,,,
"G4801390","1860","Texas","480","Ellis","1390","Ellis",1050851,76495,1053059,0,75,11312,66583,213613,77895,291508,1104
"G4801410","1860","Texas","480","El Paso","1410","El Paso",103020,11367,278991,80,4325,485,39489,49590,39974,89564,15
"G4801415","1860","Texas","480","Encinal","1415","Encinal",,,,,,,,,,,0
"G4801430","1860","Texas","480","Erath","1430","Erath",101809,30050,412672,150,15,13029,40536,33595,53565,87160,118
"G4801450","1860","Texas","480","Falls","1450","Falls",482563,25274,432296,0,0,518,33779,156934,34297,191231,1716
"G4801470","1860","Texas","480","Fannin","1470","Fannin",1508806,102830,650885,215,0,12713,84516,383617,97229,480846,1721
"G4801490","1860","Texas","480","Fayette","1490","Fayette",2518614,163899,1107731,40,556,8,104251,776994,104259,881253,3786
"G4801570","1860","Texas","480","Fort Bend","1570","Fort Bend",3310820,129175,625000,0,350,0,39353,812329,39353,851682,4127
"G4801610","1860","Texas","480","Freestone","1610","Freestone",608371,71726,574294,1210,0,5350,78929,498701,84279,582980,3613
"G4801630","1860","Texas","480","Frio","1630","Frio",,,,,,,,,,,2
"G4801670","1860","Texas","480","Galveston","1670","Galveston",204495,6783,145865,16,18150,0,4129,36833,4129,40962,1520
"G4801710","1860","Texas","480","Gillespie","1710","Gillespie",164695,34372,313990,0,386,199,10191,30264,10390,40654,33
"G4801750","1860","Texas","480","Goliad","1750","Goliad",448010,32060,604498,0,0,18010,30205,101493,48215,149708,843
"G4801770","1860","Texas","480","Gonzales","1770","Gonzales",1377738,91977,1089239,0,0,2945,75762,438937,78707,517644,3168
"G4801810","1860","Texas","480","Grayson","1810","Grayson",2041180,93215,859186,1005,235,15909,95715,327803,111624,439427,1292
"G4801850","1860","Texas","480","Grimes","1850","Grimes",3043092,95908,766730,0,150,0,91867,1090286,91867,1182153,5468
"G4801870","1860","Texas","480","Guadalupe","1870","Guadalupe",1149053,67093,895722,30,862,1778,46716,207966,48494,256460,1748
"G4801930","1860","Texas","480","Hamilton","1930","Hamilton",6060,190,6200,0,0,80,600,2322,680,3002,26
"G4801970","1860","Texas","480","Hardeman","1970","Hardeman",,,,,,,,,,,
"G4801990","1860","Texas","480","Hardin","1990","Hardin",65667,4723,78667,449,0,2141,9013,25459,11154,36613,191
"G4802010","1860","Texas","480","Harris","2010","Harris",478115,15674,149355,3980,100,0,12645,53517,12645,66162,2053
"G4802030","1860","Texas","480","Harrison","2030","Harrison",2668809,137536,715639,7805,137,7127,163851,1469604,170978,1640582,8784
"G4802070","1860","Texas","480","Haskell","2070","Haskell",,,,,,,,,,,
"G4802090","1860","Texas","480","Hays","2090","Hays",324567,8236,278426,0,0,0,10975,84439,10975,95414,797
"G4802130","1860","Texas","480","Henderson","2130","Henderson",498041,37148,260189,0,0,8432,44699,191182,53131,244313,1116
"G4802150","1860","Texas","480","Hidalgo","2150","Hidalgo",347750,13320,109765,0,0,0,10965,45352,10965,56317,1
"G4802170","1860","Texas","480","Hill","2170","Hill",687253,42856,593154,0,0,2120,34911,77108,37031,114139,650
"G4802230","1860","Texas","480","Hopkins","2230","Hopkins",896977,62581,757010,210,50,14334,89442,244199,103776,347975,990
"G4802250","1860","Texas","480","Houston","2250","Houston",1154435,115131,573745,0,0,26260,122829,525094,149089,674183,2819
"G4802310","1860","Texas","480","Hunt","2310","Hunt",634699,45769,509508,380,160,14828,47656,125388,62484,187872,577
"G4802370","1860","Texas","480","Jack","2370","Jack",23770,3160,76785,0,0,451,3847,6971,4298,11269,50
"G4802390","1860","Texas","480","Jackson","2390","Jackson",1137864,41857,570715,909,60,1436,23655,158729,25091,183820,1194
"G4802410","1860","Texas","480","Jasper","2410","Jasper",732120,34301,183599,0,0,275,38633,267574,38908,306482,1611
"G4802450","1860","Texas","480","Jefferson","2450","Jefferson",14955,2767,121585,435,158,623,7000,17268,7623,24891,309
"G4802510","1860","Texas","480","Johnson","2510","Johnson",415848,34039,387330,291,28,6737,49644,121286,56381,177667,513
"G4802530","1860","Texas","480","Jones","2530","Jones",,,,,,,,,,,
"G4802550","1860","Texas","480","Karnes","2550","Karnes",137132,7499,629197,0,0,0,27438,31894,27438,59332,327
"G4802570","1860","Texas","480","Kaufman","2570","Kaufman",474687,38281,459262,0,0,6043,34118,100140,40161,140301,533
"G4802650","1860","Texas","480","Kerr","2650","Kerr",82910,6755,58150,0,0,4080,5212,2416,9292,11708,49
"G4802670","1860","Texas","480","Kimble","2670","Kimble",,,,,,,,,,,
"G4802710","1860","Texas","480","Kinney","2710","Kinney",3350,535,24,0,0,0,0,9068,0,9068,0
"G4802750","1860","Texas","480","Knox","2750","Knox",,,,,,,,,,,
"G4802770","1860","Texas","480","Lamar","2770","Lamar",1753530,76583,604569,1676,230,16797,78972,423271,95769,519040,2833
"G4802810","1860","Texas","480","Lampasas","2810","Lampasas",111701,12074,183933,0,0,137,8977,11776,9114,20890,153
"G4802830","1860","Texas","480","La Salle","2830","La Salle",,,,,,,,,,,
"G4802850","1860","Texas","480","Lavaca","2850","Lavaca",1328798,51957,567152,0,0,0,0,356473,0,356473,1707
"G4802890","1860","Texas","480","Leon","2890","Leon",899947,65648,432635,0,0,1343,71991,450462,73334,523796,2620
"G4802910","1860","Texas","480","Liberty","2910","Liberty",751645,40011,458248,0,1250,0,27828,127355,27828,155183,1079
"G4802930","1860","Texas","480","Limestone","2930","Limestone",663457,39351,652715,50,0,4765,51040,189617,55805,245422,1072
"G4802970","1860","Texas","480","Live Oak","2970","Live Oak",97491,1928,219105,0,0,0,4586,50,4586,4636,85
"G4802990","1860","Texas","480","Llano","2990","Llano",93258,8654,332236,0,20,0,0,1008,0,1008,54
"G4803070","1860","Texas","480","McCulloch","3070","Mcculloch",,,,,,,,,,,
"G4803090","1860","Texas","480","McLennan","3090","Mclennan",1350268,59063,916844,0,155,2657,77308,262858,79965,342823,2395
"G4803110","1860","Texas","480","McMullen","3110","Mcmullen",,,,,,,,,,,
"G4803130","1860","Texas","480","Madison","3130","Madison",272035,8053,294860,0,0,0,21086,106666,21086,127752,675
"G4803150","1860","Texas","480","Marion","3150","Marion",359635,27615,111157,625,300,780,500,249007,1280,250287,2017
"G4803190","1860","Texas","480","Mason","3190","Mason",39310,7660,114247,0,0,0,0,339,0,339,18
"G4803210","1860","Texas","480","Matagorda","3210","Matagorda",1414800,89745,374276,0,1630,0,31360,539381,31360,570741,2107
"G4803230","1860","Texas","480","Maverick","3230","Maverick",,,,,,,,,,,1
"G4803250","1860","Texas","480","Medina","3250","Medina",165067,18798,201596,0,0,0,8852,450,8852,9302,106
"G4803275","1860","Texas","480","Menora","3275","Menora",,,,,,,,,,,
"G4803310","1860","Texas","480","Milam","3310","Milam",1142767,69598,420473,0,0,1445,41938,179160,43383,222543,1542
"G4803370","1860","Texas","480","Montague","3370","Montague",25395,1861,26508,0,0,0,0,2067,0,2067,35
"G4803390","1860","Texas","480","Montgomery","3390","Montgomery",543104,22406,371511,0,0,0,31969,590488,31969,622457,2811
"G4803470","1860","Texas","480","Nacogdoches","3470","Nacogdoches",1106470,84823,485365,150,100,18239,117671,509014,135910,644924,2359
"G4803490","1860","Texas","480","Navarro","3490","Navarro",1374245,70197,922536,34,0,4750,60432,244110,65182,309292,1890
"G4803510","1860","Texas","480","Newton","3510","Newton",552081,27512,166022,0,0,60,23647,164674,23707,188381,1013
"G4803550","1860","Texas","480","Nueces","3550","Nueces",429582,4715,612394,0,20,0,19006,10252,19006,29258,216
"G4803610","1860","Texas","480","Orange","3610","Orange",24598,4114,52111,446,12,78,7689,30186,7767,37953,392
"G4803630","1860","Texas","480","Palo Pinto","3630","Palo Pinto",53095,13084,350992,500,435,2638,14248,15334,16886,32220,130
"G4803650","1860","Texas","480","Panola","3650","Panola",1358354,69030,417426,0,0,21376,80483,622483,101859,724342,3058
"G4803670","1860","Texas","480","Parker","3670","Parker",207456,8971,380241,0,0,5928,36287,76237,42215,118452,222
"G4803730","1860","Texas","480","Polk","3730","Polk",2463889,95617,461373,0,0,290,62604,620389,62894,683283,4198
"G4803770","1860","Texas","480","Presidio","3770","Presidio",,,,,,,,,,,4
"G4803870","1860","Texas","480","Red River","3870","Red River",1594258,121446,471407,351,185,16693,77736,582548,94429,676977,3039
"G4803910","1860","Texas","480","Refugio","3910","Refugio",758651,5635,929820,0,0,0,16901,25882,16901,42783,234
"G4803950","1860","Texas","480","Robertson","3950","Robertson",1616210,44587,574984,0,0,0,0,394681,0,394681,2258
"G4803990","1860","Texas","480","Runnels","3990","Runnels",,,,,,,,,,,
"G4804010","1860","Texas","480","Rusk","4010","Rusk",2538442,133786,750118,50,1163,22185,183028,968605,205213,1173818,6132
"G4804030","1860","Texas","480","Sabine","4030","Sabine",245347,23675,130497,0,0,3428,22863,156396,26291,182687,1150
"G4804050","1860","Texas","480","San Augustine","4050","San Augustine",472062,45637,207253,0,0,4483,40920,1604506,45403,1649909,1717
"G4804090","1860","Texas","480","San Patricio","4090","San Patricio",181193,3615,435065,0,0,0,8393,1801,8393,10194,95
"G4804110","1860","Texas","480","San Saba","4110","San Saba",145807,9588,234417,0,0,0,0,3147,0,3147,89
"G4804170","1860","Texas","480","Shackelford","4170","Shackelford",500,125,960,0,0,0,100,3321,100,3421,9
"G4804190","1860","Texas","480","Shelby","4190","Shelby",308918,63360,303764,225,0,19051,74766,312238,93817,406055,1476
"G4804230","1860","Texas","480","Smith","4230","Smith",1843826,140486,590997,0,0,31619,135738,848207,167357,1015564,4982
"G4804270","1860","Texas","480","Starr","4270","Starr",117875,1476,68280,0,0,0,0,8210,0,8210,6
"G4804390","1860","Texas","480","Tarrant","4390","Tarrant",,,,,,,,,,,850
"G4804410","1860","Texas","480","Taylor","4410","Taylor",,,,,,,,,,,
"G4804470","1860","Texas","480","Throckmorton","4470","Throckmorton",,,,,,,,,,,0
"G4804490","1860","Texas","480","Titus","4490","Titus",1448531,87212,557993,4548,0,30820,90173,470797,120993,591790,2438
"G4804530","1860","Texas","480","Travis","4530","Travis",2305038,154085,1071136,130,8369,813,47318,288423,48131,336554,3136
"G4804550","1860","Texas","480","Trinity","4550","Trinity",281239,8765,176576,0,270,2310,68364,206905,70674,277579,959
"G4804570","1860","Texas","480","Tyler","4570","Tyler",559119,30055,254546,0,0,5286,45747,296761,51033,347794,1148
"G4804590","1860","Texas","480","Upshur","4590","Upshur",1734452,92915,533802,0,0,3780,109116,613592,112896,726488,3794
"G4804630","1860","Texas","480","Uvalde","4630","Uvalde",34616,2510,53692,0,0,0,0,0,0,0,27
"G4804670","1860","Texas","480","Van Zandt","4670","Van Zandt",273041,28714,218130,122,0,14024,25077,88756,39101,127857,322
"G4804690","1860","Texas","480","Victoria","4690","Victoria",967414,48465,534314,617,195,4630,28008,179884,32638,212522,1413
"G4804710","1860","Texas","480","Walker","4710","Walker",1525411,59092,420871,0,0,300,63597,748896,63897,812793,4135
"G4804770","1860","Texas","480","Washington","4770","Washington",4313993,198553,1064077,1000,0,100,143641,1400792,143741,1544533,7941
"G4804790","1860","Texas","480","Webb","4790","Webb",700,30,640,0,0,0,0,1467,0,1467,0
"G4804810","1860","Texas","480","Wharton","4810","Wharton",1816560,97965,384485,0,20689,3159,41112,680426,44271,724697,2734
"G4804910","1860","Texas","480","Williamson","4910","Williamson",833418,57816,823053,0,70356,958,58849,193698,59807,253505,891
"G4804970","1860","Texas","480","Wise","4970","Wise",138870,14425,184160,0,31585,3302,15625,63011,18927,81938,128
"G4804990","1860","Texas","480","Wood","4990","Wood",481879,36456,220123,220,0,23647,39783,144616,63430,208046,1005
"G4805030","1860","Texas","480","Young","5030","Young",27290,3265,41510,0,15,0,2190,4921,2190,7111,92
"G4805050","1860","Texas","480","Zapata","5050","Zapata",5750,473,6048,0,0,0,0,6949,0,6949,0
"G4805070","1860","Texas","480","Zavala","5070","Zavala",,,,,,,,,,,0
"G4950015","1860","Utah Territory","495","Beaver","0015","Beaver",13129,7840,47507,0,0,976,6752,18446,7728,26174,0
"G4950035","1860","Utah Territory","495","Box Elder","0035","Box Elder",84075,7624,69835,0,0,1284,11519,41140,12803,53943,0
"G4950055","1860","Utah Territory","495","Cache","0055","Cache",132130,17059,118963,0,0,1700,15415,62447,17115,79562,0
"G4950075","1860","Utah Territory","495","Carson","0075","Carson",302340,10981,177553,0,2225,300,8185,29656,8485,38141,
"G4950095","1860","Utah Territory","495","Cedar","0095","Cedar",6735,3231,21355,0,0,275,3198,10778,3473,14251,0
"G4950115","1860","Utah Territory","495","Davis","0115","Davis",255899,18101,140956,140,0,2907,23823,82625,26730,109355,10
"G4950135","1860","Utah Territory","495","Deseret","0135","Deseret",,,,,,,,,,,
"G4950215","1860","Utah Territory","495","Greasewood","0215","Greasewood",,,,,,,,,,,
"G4950255","1860","Utah Territory","495","Green River","0255","Green River",1000,600,5500,0,0,0,800,1362,800,2162,0
"G4950275","1860","Utah Territory","495","Humboldt","0275","Humboldt",,,,,,,,,,,
"G4950295","1860","Utah Territory","495","Iron","0295","Iron",18196,11290,56765,0,0,0,0,39832,0,39832,0
"G4950315","1860","Utah Territory","495","Juab","0315","Juab",7375,7198,39285,0,0,2879,7855,19189,10734,29923,0
"G4950375","1860","Utah Territory","495","Millard","0375","Millard",13868,6772,58215,0,0,1425,9412,20609,10837,31446,0
"G4950495","1860","Utah Territory","495","Salt Lake","0495","Salt Lake",290970,44161,248160,7296,9445,15974,46289,114088,62263,176351,19
"G4950535","1860","Utah Territory","495","Sanpete","0535","Sanpete",104600,33031,188722,1335,0,14833,28965,104957,43798,148755,0
"G4950575","1860","Utah Territory","495","Shambip","0575","Shambip",2320,1450,8200,0,0,805,935,4510,1740,6250,0
"G4950595","1860","Utah Territory","495","Summit","0595","Summit",,,,,,,,,,,
"G4950605","1860","Utah Territory","495","St Marys","0605","St Marys",0,100,85,0,0,0,1200,149,1200,1349,
"G4950615","1860","Utah Territory","495","Tooele","0615","Tooele",42010,6115,30070,300,225,2150,7335,20990,9485,30475,0
"G4950675","1860","Utah Territory","495","Utah","0675","Utah",129660,56652,276706,160,160,12244,47004,146634,59248,205882,0
"G4950695","1860","Utah Territory","495","Walade","0695","Walade",,,,,,,,,,,
"G4950735","1860","Utah Territory","495","Washington","0735","Washington",47064,4850,44431,0,0,4306,7522,17238,11828,29066,0
"G4950755","1860","Utah Territory","495","Weber","0755","Weber",184324,16915,162037,50,0,5093,27538,76596,32631,109227,0
"G5000010","1860","Vermont","500","Addison","0010","Addison",12477096,286923,1711862,16398,400,1563,221630,1980956,223193,2204149,
"G5000030","1860","Vermont","500","Bennington","0030","Bennington",4820364,194589,744077,19268,1891,11145,112634,1076071,123779,1199850,
"G5000050","1860","Vermont","500","Caledonia","0050","Caledonia",5277560,314513,1025232,72,129,4357,124150,1619090,128507,1747597,
"G5000070","1860","Vermont","500","Chittenden","0070","Chittenden",9140030,300314,1205791,47588,13070,734,182347,1783853,183081,1966934,
"G5000090","1860","Vermont","500","Essex","0090","Essex",1190049,69021,296938,976,475,6667,43122,436119,49789,485908,
"G5000110","1860","Vermont","500","Franklin","0110","Franklin",9794402,355048,1364635,8381,2191,1312,169559,2072259,170871,2243131,
"G5000130","1860","Vermont","500","Grand Isle","0130","Grand Isle",1920130,57024,177595,6178,280,150,26012,277574,26162,303736,
"G5000150","1860","Vermont","500","Lamoille","0150","Lamoille",3381150,201469,625141,0,0,3414,73583,1000768,76997,1077765,
"G5000170","1860","Vermont","500","Orange","0170","Orange",7314686,386794,1490908,10416,1375,6982,210985,1885296,217967,2103263,
"G5000190","1860","Vermont","500","Orleans","0190","Orleans",4973918,177540,1026201,221,0,8686,112162,1551350,120848,1672198,
"G5000210","1860","Vermont","500","Rutland","0210","Rutland",10541940,403046,1807403,34446,3347,1590,204819,2380927,206409,2587336,
"G5000230","1860","Vermont","500","Washington","0230","Washington",7088780,289281,1323830,7741,0,6054,158642,1816405,164696,1981101,
"G5000250","1860","Vermont","500","Windham","0250","Windham",6936519,247158,1495410,31876,1139,7620,176447,1793513,184067,1977580,
"G5000270","1860","Vermont","500","Windsor","0270","Windsor",9432424,383235,1946966,28132,505,3060,794708,2578172,797768,3375940,
"G5100010","1860","Virginia","510","Accomack","0010","Accomack",3979720,68738,345628,16435,100,2169,154780,584074,156949,741023,4507
"G5100030","1860","Virginia","510","Albemarle","0030","Albemarle",9157646,188079,899680,16686,787,19490,267222,1340804,286712,1627516,13916
"G5100035","1860","Virginia","510","Alexandria","0035","Alexandria",853260,19990,44445,1915,28970,0,5035,84639,5035,89674,1386
"G5100050","1860","Virginia","510","Alleghany","0050","Alleghany",1208170,27752,161153,3225,227,4550,40660,131911,45210,177121,990
"G5100070","1860","Virginia","510","Amelia","0070","Amelia",2364058,68957,372640,320,0,5193,77712,691843,82905,774748,7655
"G5100090","1860","Virginia","510","Amherst","0090","Amherst",2874596,81618,370824,8052,9242,5736,113351,615823,119087,734910,6278
"G5100110","1860","Virginia","510","Appomattox","0110","Appomattox",1902558,54538,265772,4062,180,46122,77140,347632,123262,470894,4600
"G5100150","1860","Virginia","510","Augusta","0150","Augusta",10997286,296390,1287615,15229,890,16024,254383,1104780,270407,1375187,5616
"G5100155","1860","Virginia","510","Barbour","0155","Barbour",2390269,145850,377693,4230,0,16264,53452,253678,69716,323394,95
"G5100170","1860","Virginia","510","Bath","0170","Bath",1455351,28216,187823,2728,0,7523,37716,99181,45239,144420,946
"G5100190","1860","Virginia","510","Bedford","0190","Bedford",6297453,229101,837393,26452,140,29226,260058,1202072,289284,1491356,10176
"G5100195","1860","Virginia","510","Berkeley","0195","Berkeley",3547566,79976,335757,0,600,0,93555,522150,93555,615705,1650
"G5100215","1860","Virginia","510","Boone","0215","Boone",579398,12471,120589,4531,0,8358,30879,120290,39237,159527,158
"G5100230","1860","Virginia","510","Botetourt","0230","Botetourt",3415045,76804,380728,7003,15,5236,108333,470897,113569,584466,2769
"G5100233","1860","Virginia","510","Braxton","0233","Braxton",650016,10301,109456,3083,22,7652,20327,116170,27979,144149,104
"G5100237","1860","Virginia","510","Brooke","0237","Brooke",2447903,48286,282439,8497,1615,0,36763,230494,36763,267257,18
"G5100250","1860","Virginia","510","Brunswick","0250","Brunswick",2318267,75573,430309,4595,0,12745,136857,918386,149602,1067988,9146
"G5100270","1860","Virginia","510","Buchanan","0270","Buchanan",229981,3985,68248,215,0,5141,15501,47504,20642,68146,30
"G5100290","1860","Virginia","510","Buckingham","0290","Buckingham",3513277,104154,419349,571,0,12534,127021,799625,139555,939180,8811
"G5100293","1860","Virginia","510","Cabell","0293","Cabell",1611815,30559,195674,12125,0,4518,49736,233311,54254,287565,305
"G5100297","1860","Virginia","510","Calhoun","0297","Calhoun",364617,7058,74651,1895,234,6058,13455,72268,19513,91781,9
"G5100310","1860","Virginia","510","Campbell","0310","Campbell",3712579,83323,359778,2930,7320,28451,124639,713084,153090,866174,11580
"G5100330","1860","Virginia","510","Caroline","0330","Caroline",4407613,107323,450654,852,0,12291,107750,930172,120041,1050213,10672
"G5100350","1860","Virginia","510","Carroll","0350","Carroll",867338,26302,162470,9099,45,17013,55269,189521,72282,261803,262
"G5100360","1860","Virginia","510","Charles City","0360","Charles City",1239410,45800,165955,0,75,100,32347,245742,32447,278189,2947
"G5100370","1860","Virginia","510","Charlotte","0370","Charlotte",4398140,89867,441494,4830,643,12919,135023,952312,147942,1100254,9238
"G5100410","1860","Virginia","510","Chesterfield","0410","Chesterfield",3263370,80604,399767,904,10244,4277,70567,505471,74844,580315,8354
"G5100430","1860","Virginia","510","Clarke","0430","Clarke",3645185,80170,335667,1205,0,0,70913,533651,70913,604564,3375
"G5100435","1860","Virginia","510","Clay","0435","Clay",165344,3753,41824,335,0,5325,12597,39223,17922,57145,21
"G5100450","1860","Virginia","510","Craig","0450","Craig",942745,31177,124926,5736,38,10502,29841,104292,40343,144635,420
"G5100470","1860","Virginia","510","Culpeper","0470","Culpeper",4985786,110061,540572,575,195,5071,114849,522916,119920,642836,6675
"G5100490","1860","Virginia","510","Cumberland","0490","Cumberland",2355423,69181,352135,0,0,8586,81191,646060,89777,735837,6705
"G5100530","1860","Virginia","510","Dinwiddie","0530","Dinwiddie",2643250,120296,484278,3145,4903,5123,97762,715790,102885,818675,12774
"G5100533","1860","Virginia","510","Doddridge","0533","Doddridge",1006326,16602,142269,25,155,4971,24848,124097,29819,153916,34
"G5100550","1860","Virginia","510","Elizabeth City","0550","Elizabeth City",1273050,26130,123845,4210,5795,0,39767,156240,39767,196007,2417
"G5100570","1860","Virginia","510","Essex","0570","Essex",2439173,57320,269403,756,700,12554,66540,587328,79094,666422,6696
"G5100590","1860","Virginia","510","Fairfax","0590","Fairfax",3866075,111097,371443,6715,12605,834,68491,372504,69325,441829,3116
"G5100610","1860","Virginia","510","Fauquier","0610","Fauquier",10062472,241740,1494504,2287,667,9311,230192,913620,239503,1153123,10455
"G5100615","1860","Virginia","510","Fayette","0615","Fayette",1224096,25440,177440,5473,110,13787,44107,146709,57894,204603,271
"G5100630","1860","Virginia","510","Floyd","0630","Floyd",1023165,49247,216151,5191,0,16505,58633,228858,75138,303996,475
"G5100650","1860","Virginia","510","Fluvanna","0650","Fluvanna",2332149,73404,318213,0,0,5370,82686,518152,88056,606208,4994
"G5100670","1860","Virginia","510","Franklin","0670","Franklin",3684634,108484,493103,17257,124,30736,164530,705868,195266,901134,6351
"G5100690","1860","Virginia","510","Frederick","0690","Frederick",3987945,148515,519296,7518,1289,4203,96524,548534,100727,649261,2259
"G5100710","1860","Virginia","510","Giles","0710","Giles",1760806,37674,257222,3477,100,11961,66180,209879,78141,288020,778
"G5100715","1860","Virginia","510","Gilmer","0715","Gilmer",622965,13738,113722,2946,1227,8717,21167,139780,29884,169664,52
"G5100730","1860","Virginia","510","Gloucester","0730","Gloucester",2001234,60518,225926,3075,0,5695,70321,296494,76016,372510,5736
"G5100750","1860","Virginia","510","Goochland","0750","Goochland",2524327,80435,348457,0,130,3678,77718,640261,81396,721657,6139
"G5100770","1860","Virginia","510","Grayson","0770","Grayson",1432258,58241,339552,16374,2361,28492,76259,270090,104751,374841,547
"G5100775","1860","Virginia","510","Greenbrier","0775","Greenbrier",5713422,86286,676298,0,350,25643,114265,306096,139908,446004,1525
"G5100790","1860","Virginia","510","Greene","0790","Greene",1213979,36651,154767,420,0,6129,49942,201982,56071,258053,1984
"G5100810","1860","Virginia","510","Greensville","0810","Greensville",982900,37025,186375,676,0,6433,69495,311979,75928,387907,4167
"G5100830","1860","Virginia","510","Halifax","0830","Halifax",6922479,147181,684536,6729,2430,57970,257810,1398041,315780,1713821,14897
"G5100833","1860","Virginia","510","Hampshire","0833","Hampshire",3947900,166316,763454,15563,0,22756,109834,537923,132590,670513,1213
"G5100837","1860","Virginia","510","Hancock","0837","Hancock",1676745,38489,182746,9411,300,0,26396,152067,26396,178463,2
"G5100850","1860","Virginia","510","Hanover","0850","Hanover",4203120,142934,514828,825,52645,5684,122116,900030,127800,1027830,9483
"G5100853","1860","Virginia","510","Hardy","0853","Hardy",2579581,57753,453768,6220,50,10256,71698,280919,81954,362873,1073
"G5100857","1860","Virginia","510","Harrison","0857","Harrison",4642794,63261,644325,6817,57,7889,75883,371846,83772,455618,582
"G5100870","1860","Virginia","510","Henrico","0870","Henrico",5128610,145114,423672,3895,80280,1042,115479,610181,116521,726702,20041
"G5100890","1860","Virginia","510","Henry","0890","Henry",2341356,38369,282659,6019,0,15537,107290,468668,122827,591495,5018
"G5100910","1860","Virginia","510","Highland","0910","Highland",1535379,20813,269337,0,0,8609,25592,97797,34201,131998,402
"G5100930","1860","Virginia","510","Isle Of Wight","0930","Isle Of Wight",1531290,44440,252697,32145,2875,6378,135052,361527,141430,502957,3570
"G5100935","1860","Virginia","510","Jackson","0935","Jackson",1355201,33410,173354,9281,21,8908,40260,267847,49168,317015,55
"G5100950","1860","Virginia","510","James City","0950","James City",1011340,28609,125593,821,890,1196,30024,139731,31220,170951,2586
"G5100953","1860","Virginia","510","Jefferson","0953","Jefferson",5652143,119176,466168,1305,180,7825,110221,725913,118046,843959,3960
"G5100957","1860","Virginia","510","Kanawha","0957","Kanawha",1895918,34246,197224,2047,860,1382,56345,287423,57727,345150,2184
"G5100970","1860","Virginia","510","King And Queen","0970","King And Queen",2454708,57015,252349,100,0,12658,71575,350513,84233,434746,6139
"G5100990","1860","Virginia","510","King George","0990","King George",1933469,56531,203691,205,150,2350,40214,333954,42564,376518,3673
"G5101010","1860","Virginia","510","King William","1010","King William",2568250,80172,232290,595,0,11700,70225,429927,81925,511852,5525
"G5101030","1860","Virginia","510","Lancaster","1030","Lancaster",1307441,60143,131475,1223,137,10714,43115,183422,53829,237251,2869
"G5101050","1860","Virginia","510","Lee","1050","Lee",2768021,42785,447142,8028,330,17986,96396,427046,114382,541428,824
"G5101053","1860","Virginia","510","Lewis","1053","Lewis",1327743,23582,225500,2812,0,10142,28817,166560,38959,205519,230
"G5101057","1860","Virginia","510","Logan","1057","Logan",558443,9790,161490,3882,4388,12474,30559,140363,43033,183396,148
"G5101070","1860","Virginia","510","Loudoun","1070","Loudoun",10508212,238264,1182355,3823,5,4258,202746,1108777,207004,1315781,5501
"G5101090","1860","Virginia","510","Louisa","1090","Louisa",4461836,108245,556856,1990,15,10176,130827,1069845,141003,1210848,10194
"G5101110","1860","Virginia","510","Lunenburg","1110","Lunenburg",2232979,62961,360642,0,0,20168,88920,684924,109088,794012,7305
"G5101130","1860","Virginia","510","Madison","1130","Madison",2816620,91377,321897,4945,0,12122,113843,394875,125965,520840,4397
"G5101133","1860","Virginia","510","Marion","1133","Marion",3115337,55057,466254,11703,0,14179,55990,301098,70169,371267,63
"G5101135","1860","Virginia","510","Marshall","1135","Marshall",2489909,58262,280860,17320,3840,7602,44944,337010,52546,389556,29
"G5101137","1860","Virginia","510","Mason","1137","Mason",1951283,37761,252063,6739,0,3670,55706,274863,59376,334239,376
"G5101150","1860","Virginia","510","Mathews","1150","Matthews",1450460,34214,127970,4573,91,5350,58164,163437,63514,226951,3008
"G5101155","1860","Virginia","510","McDowell","1155","Mcdowell",100655,2088,33785,100,0,2862,8138,15612,11000,26612,0
"G5101170","1860","Virginia","510","Mecklenburg","1170","Mecklenburg",3606956,99175,481246,8155,0,24427,144805,1098888,169232,1268120,12420
"G5101175","1860","Virginia","510","Mercer","1175","Mercer",1540185,33844,244954,0,20,30885,58132,192819,89017,281836,362
"G5101190","1860","Virginia","510","Middlesex","1190","Middlesex",1145060,31603,110887,555,20,3212,41654,153046,44866,197912,2375
"G5101193","1860","Virginia","510","Monongalia","1193","Monongalia",2884916,59257,454070,9376,103,13290,46994,316935,60284,377219,101
"G5101197","1860","Virginia","510","Monroe","1197","Monroe",3768775,73807,500268,3587,20,20335,78506,315293,98841,414134,1114
"G5101210","1860","Virginia","510","Montgomery","1210","Montgomery",3062680,67537,378313,5000,800,8248,96872,406058,105120,511178,2219
"G5101215","1860","Virginia","510","Morgan","1215","Morgan",479987,27931,111439,3238,270,2190,21325,87971,23515,111486,94
"G5101230","1860","Virginia","510","Nansemond","1230","Nansemond",1680210,42312,244452,10204,1935,5853,150185,359457,156038,515495,5481
"G5101250","1860","Virginia","510","Nelson","1250","Nelson",4009504,80798,352344,3721,243,6016,126182,574386,132198,706584,6238
"G5101270","1860","Virginia","510","New Kent","1270","New Kent",1331275,55402,170821,2221,1465,1875,31365,192423,33240,225663,3374
"G5101275","1860","Virginia","510","Nicholas","1275","Nicholas",3607259,43651,334820,5516,13733,24543,64227,160769,88770,249539,154
"G5101290","1860","Virginia","510","Norfolk","1290","Norfolk",2140252,40836,251378,11508,292968,1315,97299,655127,98614,753741,9004
"G5101310","1860","Virginia","510","Northampton","1310","Northampton",2184150,47720,208875,742,25,1798,86525,349627,88323,437950,3872
"G5101330","1860","Virginia","510","Northumberland","1330","Northumberland",1701047,58624,199833,1019,870,5264,68792,238719,74056,312775,3439
"G5101350","1860","Virginia","510","Nottoway","1350","Nottoway",1729186,47567,215527,10,0,5241,50313,505842,55554,561396,6468
"G5101355","1860","Virginia","510","Ohio","1355","Ohio",2423520,50640,253090,10174,14420,0,26930,241235,26930,268165,100
"G5101370","1860","Virginia","510","Orange","1370","Orange",3779299,104266,448384,0,0,6122,97468,509993,103590,613583,6111
"G5101390","1860","Virginia","510","Page","1390","Page",2192549,80420,288509,9982,35,9828,71447,291812,81275,373087,850
"G5101410","1860","Virginia","510","Patrick","1410","Patrick",1278805,23296,202808,15668,2,13644,69996,237706,83640,321346,2070
"G5101415","1860","Virginia","510","Pendleton","1415","Pendleton",1606532,47838,371228,1932,0,14614,45319,162601,59933,222534,244
"G5101430","1860","Virginia","510","Pittsylvania","1430","Pittsylvania",5760940,131565,700695,5074,0,32137,223732,1226107,255869,1481976,14340
"G5101433","1860","Virginia","510","Pleasants","1433","Pleasants",649220,12752,84275,5868,55,2604,15284,99953,17888,117841,15
"G5101437","1860","Virginia","510","Pocahontas","1437","Pocahontas",2051780,39937,328002,95,0,14846,41554,116144,56400,172544,252
"G5101450","1860","Virginia","510","Powhatan","1450","Powhatan",2100284,70369,273279,1351,25,8426,69105,601668,77531,679199,5403
"G5101455","1860","Virginia","510","Preston","1455","Preston",2257314,100929,461133,40,0,20088,80407,243423,100495,343918,67
"G5101470","1860","Virginia","510","Prince Edward","1470","Prince Edward",2957131,61744,297433,1583,45,11452,69241,631697,80693,712390,7341
"G5101490","1860","Virginia","510","Prince George","1490","Prince George",1947415,74674,228861,1800,7325,2560,53799,446359,56359,502718,4997
"G5101510","1860","Virginia","510","Princess Anne","1510","Princess Anne",1860486,40880,290847,5253,5575,4535,106255,295681,110790,406471,3186
"G5101530","1860","Virginia","510","Prince William","1530","Prince William",2373100,63366,318445,1493,0,2863,62089,247114,64952,312066,2356
"G5101550","1860","Virginia","510","Pulaski","1550","Pulaski",2337220,42154,288451,754,0,12372,83230,239596,95602,335198,1589
"G5101553","1860","Virginia","510","Putnam","1553","Putnam",1266592,33717,185995,9519,0,36693,57165,249062,93858,342920,580
"G5101555","1860","Virginia","510","Raleigh","1555","Raleigh",414672,9354,69038,1039,0,7086,13363,49555,20449,70004,57
"G5101557","1860","Virginia","510","Randolph","1557","Randolph",1628295,20880,244857,431,0,10594,24883,112336,35477,147813,183
"G5101570","1860","Virginia","510","Rappahannock","1570","Rappahannock",2860410,66023,407815,6386,11,7109,86409,332651,93518,426169,3520
"G5101590","1860","Virginia","510","Richmond","1590","Richmond",1270037,32889,148261,109,0,3443,49427,229634,52870,282504,2466
"G5101593","1860","Virginia","510","Ritchie","1593","Ritchie",1500626,31083,213147,2880,0,9550,35763,172848,45313,218161,38
"G5101597","1860","Virginia","510","Roane","1597","Roane",531702,12179,86180,2380,30,6305,20571,103531,26876,130407,72
"G5101610","1860","Virginia","510","Roanoke","1610","Roanoke",2323226,61690,254689,628,104,1900,59857,405580,61757,467337,2643
"G5101630","1860","Virginia","510","Rockbridge","1630","Rockbridge",5785123,109223,652399,13782,81,53617,168764,648104,222381,870485,3985
"G5101650","1860","Virginia","510","Rockingham","1650","Rockingham",9718614,262506,1139690,16351,150,13973,260691,1062202,274664,1336866,2387
"G5101670","1860","Virginia","510","Russell","1670","Russell",2324483,46806,496824,16494,0,29937,89264,331356,119201,450557,1099
"G5101690","1860","Virginia","510","Scott","1690","Scott",2085722,49095,425210,11295,0,30386,101055,397542,131441,528983,490
"G5101710","1860","Virginia","510","Shenandoah","1710","Shenandoah",4035255,99133,366153,553,0,6676,83204,377711,89880,467591,753
"G5101730","1860","Virginia","510","Smyth","1730","Smyth",2626469,45325,308951,8477,0,12560,61538,311978,74098,386076,1037
"G5101750","1860","Virginia","510","Southampton","1750","Southampton",1615065,77852,374105,61642,0,8084,258363,674007,266447,940454,5408
"G5101770","1860","Virginia","510","Spotsylvania","1770","Spotsylvania",2394424,78794,313797,10,300,5439,66267,451690,71706,523396,7786
"G5101790","1860","Virginia","510","Stafford","1790","Stafford",1536580,46085,202073,733,3293,2286,53134,223573,55420,278993,3314
"G5101810","1860","Virginia","510","Surry","1810","Surry",1082056,28597,152802,12577,0,1177,49860,191240,51037,242277,2515
"G5101830","1860","Virginia","510","Sussex","1830","Sussex",1601905,71498,359821,20311,310,17816,130560,494695,148376,643071,6384
"G5101835","1860","Virginia","510","Taylor","1835","Taylor",1090010,21937,162864,2686,0,5494,22383,114646,27877,142523,112
"G5101850","1860","Virginia","510","Tazewell","1850","Tazewell",2878107,56406,485525,0,0,26003,74772,242610,100775,343385,1202
"G5101853","1860","Virginia","510","Tucker","1853","Tucker",279308,5735,58850,520,0,3217,7721,28837,10938,39775,20
"G5101855","1860","Virginia","510","Tyler","1855","Tyler",1500003,35696,202707,11997,0,10354,35150,214135,45504,259639,18
"G5101857","1860","Virginia","510","Upshur","1857","Upshur",1665426,33161,271523,8705,0,17545,35217,179968,52762,232730,212
"G5101870","1860","Virginia","510","Warren","1870","Warren",2205979,44739,299090,1258,259,4552,49132,257347,53684,311031,1575
"G5101890","1860","Virginia","510","Warwick","1890","Warwick",406250,9486,55682,30,0,700,19645,64149,20345,84494,1019
"G5101910","1860","Virginia","510","Washington","1910","Washington",4123233,95392,569489,16374,0,27341,145224,617373,172565,789938,2547
"G5101913","1860","Virginia","510","Wayne","1913","Wayne",893758,18766,175008,4526,20,11697,40241,182760,51938,234698,143
"G5101917","1860","Virginia","510","Webster","1917","Webster",203722,2814,44304,0,0,3257,6439,22838,9696,32534,3
"G5101930","1860","Virginia","510","Westmoreland","1930","Westmoreland",1931680,47030,219364,0,0,0,43643,330511,43643,374154,3704
"G5101933","1860","Virginia","510","Wetzel","1933","Wetzel",1176511,20687,169639,7510,46,7556,28182,189318,35738,225056,10
"G5101937","1860","Virginia","510","Wirt","1937","Wirt",579126,12042,110417,2409,0,6049,22749,120672,28798,149470,23
"G5101950","1860","Virginia","510","Wise","1950","Wise",506618,13648,123250,1882,0,10020,33186,92665,43206,135871,66
"G5101953","1860","Virginia","510","Wood","1953","Wood",1673864,37868,214077,2460,1535,6366,51682,261882,58048,319930,176
"G5101957","1860","Virginia","510","Wyoming","1957","Wyoming",234595,7142,81992,1045,38,6275,14740,54973,21015,75988,64
"G5101970","1860","Virginia","510","Wythe","1970","Wythe",3793227,91461,411815,9481,698,20038,124374,412413,144412,556825,2162
"G5101990","1860","Virginia","510","York","1990","York",1167320,27505,124627,1275,996,1890,34849,151505,36739,188244,1925
"G5350015","1860","Washington Territory","535","Chihallis","0015","Chihallis",49500,2785,20635,0,625,0,3185,4886,3185,8071,
"G5350035","1860","Washington Territory","535","Clallam","0035","Clallam",90300,3635,13773,0,100,0,0,16611,0,16611,
"G5350055","1860","Washington Territory","535","Clark","0055","Clark",428510,23336,139653,14291,12239,26728,21308,74874,48036,122910,
"G5350095","1860","Washington Territory","535","Cowlitz","0095","Cowlitz",153400,5469,42078,2615,3105,3962,5015,20641,8977,29618,
"G5350115","1860","Washington Territory","535","Island","0115","Island",,,,,,,1350,,1350,1350,
"G5350135","1860","Washington Territory","535","Jefferson","0135","Jefferson",75250,2860,13220,300,1480,0,4800,7988,4800,12788,
"G5350155","1860","Washington Territory","535","King","0155","King",56150,3225,23785,0,0,0,0,9429,0,9429,
"G5350175","1860","Washington Territory","535","Kitsap","0175","Kitsap",,,,,,,,,,,
"G5350195","1860","Washington Territory","535","Klikatat","0195","Klikatat",48550,6270,75756,0,0,0,2008,940,2008,2948,
"G5350215","1860","Washington Territory","535","Lewis","0215","Lewis",287785,20745,97070,0,0,0,4270,25803,4270,30073,
"G5350255","1860","Washington Territory","535","Pacific","0255","Pacific",49400,2180,21851,170,810,40,4550,8127,4590,12717,
"G5350275","1860","Washington Territory","535","Pierce","0275","Pierce",178940,23360,157775,0,0,210,22865,34477,23075,57552,
"G5350355","1860","Washington Territory","535","Skamania","0355","Skamania",17800,1193,5830,75,1825,717,2315,3846,3032,6878,
"G5350375","1860","Washington Territory","535","Sawamish","0375","Sawamish",69417,5808,16717,118,1575,0,390,6185,390,6575,
"G5350415","1860","Washington Territory","535","Spokane","0415","Spokane",79300,14205,42038,0,100,0,7589,13365,7589,20954,
"G5350455","1860","Washington Territory","535","Thurston","0455","Thurston",362930,40521,225830,1300,310,1749,20014,57658,21763,79421,
"G5350475","1860","Washington Territory","535","Wahkiakum","0475","Wahkiakum",77400,1640,5565,1250,780,100,750,3423,850,4273,
"G5350495","1860","Washington Territory","535","Walla Walla","0495","Walla Walla",179810,32920,189860,0,1400,0,500,22246,500,22746,
"G5350515","1860","Washington Territory","535","Whatcom","0515","Whatcom",13400,250,8475,500,50,0,0,820,0,820,
"G5500010","1860","Wisconsin","550","Adams","0010","Adams",754940,43211,125442,10,0,240,27353,190435,27593,218028,
"G5500030","1860","Wisconsin","550","Ashland","0030","Ashland",140350,1585,5050,100,325,0,761,6429,761,7190,
"G5500035","1860","Wisconsin","550","Bad Ax","0035","Bad Ax",1295153,66729,251573,138,8278,2573,46859,389630,49432,439062,
"G5500090","1860","Wisconsin","550","Brown","0090","Brown",305104,18378,49025,53,4635,195,9198,73836,9393,83229,
"G5500110","1860","Wisconsin","550","Buffalo","0110","Buffalo",448536,20574,109282,0,0,200,19624,183372,19824,203196,
"G5500130","1860","Wisconsin","550","Burnett","0130","Burnett",,,,,,,,,,,
"G5500150","1860","Wisconsin","550","Calumet","0150","Calumet",970555,55722,149612,0,0,278,36579,224402,36857,261259,
"G5500170","1860","Wisconsin","550","Chippewa","0170","Chippewa",93650,3656,17516,0,0,0,3793,28200,3793,31993,
"G5500190","1860","Wisconsin","550","Clark","0190","Clark",107015,4621,19244,0,0,0,3586,21593,3586,25179,
"G5500210","1860","Wisconsin","550","Columbia","0210","Columbia",5663789,248897,793770,3503,1820,1379,133636,1564782,135015,1699797,
"G5500230","1860","Wisconsin","550","Crawford","0230","Crawford",378859,21202,74058,423,765,600,17575,110615,18175,128790,
"G5500235","1860","Wisconsin","550","Dallas","0235","Dallas",,,,,,,,,,,
"G5500250","1860","Wisconsin","550","Dane","0250","Dane",9423494,402566,1344669,1769,3340,2452,252567,2646043,255019,2901062,
"G5500270","1860","Wisconsin","550","Dodge","0270","Dodge",8589664,362819,1069933,8482,3522,8238,196609,2232856,204847,2437703,
"G5500290","1860","Wisconsin","550","Door","0290","Door",93152,3081,12958,0,550,0,1641,23317,1641,24958,
"G5500310","1860","Wisconsin","550","Douglas","0310","Douglas",35300,685,6060,0,100,0,1020,3019,1020,4039,
"G5500330","1860","Wisconsin","550","Dunn","0330","Dunn",209330,11837,52608,0,1123,0,17381,83403,17381,100784,
"G5500350","1860","Wisconsin","550","Eau Claire","0350","Eau Claire",288390,15926,49370,0,1791,0,10083,99432,10083,109515,
"G5500390","1860","Wisconsin","550","Fond du Lac","0390","Fond Du Lac",6803384,268322,888448,2570,3253,3123,147561,1866935,150684,2017619,
"G5500430","1860","Wisconsin","550","Grant","0430","Grant",5001359,284991,874383,5983,8600,6964,185578,1530299,192542,1722841,
"G5500450","1860","Wisconsin","550","Green","0450","Green",5061339,241438,791439,2812,877,9181,177836,1182445,187017,1369462,
"G5500470","1860","Wisconsin","550","Green Lake","0470","Green Lake",3216900,136065,552805,989,2639,291,81921,890952,82212,973164,
"G5500490","1860","Wisconsin","550","Iowa","0490","Iowa",2808453,173545,501307,726,5711,312,95694,847458,96006,943464,
"G5500530","1860","Wisconsin","550","Jackson","0530","Jackson",471490,24283,73671,0,1192,0,17490,159262,17490,176752,
"G5500550","1860","Wisconsin","550","Jefferson","0550","Jefferson",5057531,203997,665523,7644,2460,1163,154183,954435,155346,1109781,
"G5500570","1860","Wisconsin","550","Juneau","0570","Juneau",697481,36752,119975,0,5294,1151,22126,207988,23277,231265,
"G5500590","1860","Wisconsin","550","Kenosha","0590","Kenosha",3475409,143726,448229,2790,12834,15639,78019,799868,93658,893526,
"G5500610","1860","Wisconsin","550","Kewaunee","0610","Kewaunee",1014520,47826,139923,0,8808,0,24821,279456,24821,304277,
"G5500630","1860","Wisconsin","550","La Crosse","0630","La Crosse",1641935,111922,239160,0,2260,0,0,453265,0,453265,
"G5500650","1860","Wisconsin","550","Lafayette","0650","Lafayette",3304754,192631,571098,1598,762,1734,105129,1013794,106863,1120657,
"G5500675","1860","Wisconsin","550","La Point","0675","La Point",36600,675,2960,0,200,0,410,1740,410,2150,
"G5500710","1860","Wisconsin","550","Manitowoc","0710","Manitowoc",801102,36458,86213,0,0,100,20031,139557,20131,159688,
"G5500730","1860","Wisconsin","550","Marathon","0730","Marathon",113040,5284,14757,0,0,0,2144,26174,2144,28318,
"G5500770","1860","Wisconsin","550","Marquette","0770","Marquette",1017305,57008,237279,110,223,526,45741,331930,46267,378197,
"G5500790","1860","Wisconsin","550","Milwaukee","0790","Milwaukee",6236295,151010,390165,4106,51451,677,73229,542278,73906,616184,
"G5500810","1860","Wisconsin","550","Monroe","0810","Monroe",1019155,47576,143346,0,0,160,24096,250564,24256,274820,
"G5500830","1860","Wisconsin","550","Oconto","0830","Oconto",103770,4727,21274,0,780,0,4038,22410,4038,26448,
"G5500870","1860","Wisconsin","550","Outagamie","0870","Outagamie",1355713,51864,185642,330,36749,17349,35497,264197,52846,317043,
"G5500890","1860","Wisconsin","550","Ozaukee","0890","Ozaukee",2370375,145790,267962,138,106,1163,57001,367527,58164,425691,
"G5500910","1860","Wisconsin","550","Pepin","0910","Pepin",228780,10354,35543,0,312,20,8263,57094,8283,65377,
"G5500930","1860","Wisconsin","550","Pierce","0930","Pierce",533001,30505,89736,20,182,3100,18714,173079,21814,194893,
"G5500950","1860","Wisconsin","550","Polk","0950","Polk",114890,5290,21002,0,0,0,3076,30172,3076,33248,
"G5500970","1860","Wisconsin","550","Portage","0970","Portage",689125,33952,114241,0,0,1473,20167,179461,21640,201101,
"G5501010","1860","Wisconsin","550","Racine","1010","Racine",4297580,176689,500698,2666,10439,9382,72668,694577,82050,776627,
"G5501030","1860","Wisconsin","550","Richland","1030","Richland",1456780,74496,242669,0,85,2161,56154,310210,58315,368525,
"G5501050","1860","Wisconsin","550","Rock","1050","Rock",10909806,429607,1233831,7950,9119,19567,216992,2287038,236559,2523597,
"G5501090","1860","Wisconsin","550","St Croix","1090","St Croix",681973,34563,95919,0,0,333,19180,203471,19513,222984,
"G5501110","1860","Wisconsin","550","Sauk","1110","Sauk",3172138,148187,493847,497,2,312,106507,780743,106819,887562,
"G5501150","1860","Wisconsin","550","Shawano","1150","Shawano",29500,1630,4867,0,0,0,997,6757,997,7754,
"G5501170","1860","Wisconsin","550","Sheboygan","1170","Sheboygan",3805650,207909,514311,12,4671,1056,95416,650682,96472,747154,
"G5501210","1860","Wisconsin","550","Trempealeau","1210","Trempealeau",367240,12516,78632,0,0,0,12432,130966,12432,143398,
"G5501270","1860","Wisconsin","550","Walworth","1270","Walworth",6778235,254306,898637,9347,10674,5369,187462,1487244,192831,1680075,
"G5501310","1860","Wisconsin","550","Washington","1310","Washington",3916598,163001,470995,2563,103,4966,93338,715257,98304,813561,
"G5501330","1860","Wisconsin","550","Waukesha","1330","Waukesha",7530996,257585,810692,9854,1257,2649,159523,1179213,162172,1341385,
"G5501350","1860","Wisconsin","550","Waupaca","1350","Waupaca",1063226,43714,138611,6,320,498,31195,226972,31693,258665,
"G5501370","1860","Wisconsin","550","Waushara","1370","Waushara",1121040,57064,216216,223,800,991,49818,359347,50809,410156,
"G5501390","1860","Wisconsin","550","Winnebago","1390","Winnebago",3958617,164985,488929,1278,318,407,79699,880655,80106,960761,
"G5501410","1860","Wisconsin","550","Wood","1410","Wood",56800,5115,12270,0,0,0,2850,8646,2850,11496,
